LotNo,Qty Unique Chip-id Bin1,Qty Redundant Chip-id,Qty Camstar at Bake-in,Result,Qty Camstar-Unique Chip-Id,Tested Date,Test Sequence
5I315178501,4035,4031,4023,OK,-12,['2023-05-31 20:36:35'],['NR']
5I315357501,9764,9719,9762,OK,-2,['2023-05-31 09:39:11'],['NR']
5I315357501,9764,9719,9720,OK,-44,['2023-05-31 09:39:11'],['NR']
VC307335B01,26563,2,26547,OK,-16,['2023-04-11 16:42:46'],['NCCCRR']
ZA228170931,4578,154,4724,FAIL,146,['2023-04-17 09:47:14'],['NCC']
VC31008393P,28563,57,28602,FAIL,39,['2023-04-27 17:09:53'],['NCCCCRR']
VC310082948,30036,0,30036,OK,0,['2023-04-27 23:49:37'],['NCR']
VC31008393D,28457,0,28429,OK,-28,['2023-04-28 11:09:46'],['NR']
VC310082B05,26636,0,26613,OK,-23,['2023-04-28 15:23:44'],['NCRR']
VC310083931,28238,0,28238,OK,0,['2023-04-29 01:06:09'],['NR']
VC31008395L,28537,0,28537,OK,0,['2023-04-29 05:58:03'],['NR']
VC31008294J,28410,0,28397,OK,-13,['2023-04-29 11:00:24'],['NR']
VC31008395X,28413,2,28408,OK,-5,['2023-04-29 22:17:31'],['NR']
VC31008394H,26574,1389,26697,FAIL,123,['2023-05-09 11:26:04'],['NCR']
VC31008394R,30411,1,30410,OK,-1,['2023-04-30 07:43:49'],['NCR']
VC31008395R,28487,17,28487,OK,0,['2023-04-30 10:15:48'],['NR']
VC31008393V,28725,0,28713,OK,-12,['2023-05-01 01:23:57'],['NR']
VC310083B01,26672,0,26649,OK,-23,['2023-05-01 02:22:29'],['NCR']
VC310083953,28605,12,28598,OK,-7,['2023-05-01 13:47:34'],['NCRR']
VC31008393J,28611,1,28607,OK,-4,['2023-05-01 14:25:03'],['NR']
ZA228170933,4886,29,4915,FAIL,29,['2023-05-01 15:15:50'],['NCR']
ZA228170932,4906,12,4900,OK,-6,['2023-05-01 20:37:06'],['NCR']
VC310083B02,26676,0,26675,OK,-1,['2023-05-01 23:07:03'],['NR']
VC31008395F,28515,0,28513,OK,-2,['2023-05-02 01:30:58'],['NRR']
VC310083EA4,28464,0,28446,OK,-18,['2023-05-02 13:22:54'],['NCR']
VC307335931,28241,0,28240,OK,-1,['2023-05-03 04:41:52'],['NR']
VC31135893I,12264,0,12264,OK,0,['2023-05-03 16:27:13'],['NR']
VC30458493S,5126,0,5126,OK,0,['2023-05-03 22:28:40'],['N']
VC310083EB9,30650,0,30635,OK,-15,['2023-05-05 01:48:44'],['NR']
VC310083EAW,28598,0,28597,OK,-1,['2023-05-05 11:17:58'],['NR']
VC310083B16,26762,0,26762,OK,0,['2023-05-05 20:37:52'],['NR']
VC310083959,28497,7,28482,OK,-15,['2023-05-06 05:55:51'],['NR']
VC310083EAL,30538,0,30534,OK,-4,['2023-05-06 19:35:45'],['NR']
VC310083B19,26644,0,26642,OK,-2,['2023-05-07 04:19:07'],['NR']
VC310083EB3,28700,0,28700,OK,0,['2023-05-07 12:17:54'],['NR']
VC310083EBT,26488,1,26471,OK,-17,['2023-05-10 00:15:50'],['NRR']
VC310083EFV,28590,0,28574,OK,-16,['2023-05-10 10:46:55'],['NR']
VC310083EFL,28604,0,28599,OK,-5,['2023-05-10 23:44:34'],['NRR']
VC310083EBY,28488,0,28484,OK,-4,['2023-05-11 10:53:28'],['NCR']
VC310083EFA,30520,17,30518,OK,-2,['2023-05-11 23:58:45'],['NCR']
VC310083B29,26692,0,26685,OK,-7,['2023-05-12 14:31:38'],['NRR']
VC310083EBN,28363,100,28463,FAIL,100,['2023-05-12 22:03:57'],['NCCCCCRR']
VC310083B30,26569,23,26576,FAIL,7,['2023-05-12 22:24:44'],['NCCR']
VC310083EF5,26718,0,26706,OK,-12,['2023-05-13 08:48:41'],['NR']
VC310083EAA,30284,0,30266,OK,-18,['2023-05-13 19:32:31'],['NRR']
VC31008293V,28453,0,28424,OK,-29,['2023-05-13 20:42:12'],['NRR']
VC310083B36,26613,6,26601,OK,-12,['2023-05-14 07:03:02'],['NR']
VC31008394D,22121,92,22134,FAIL,13,['2023-05-14 17:24:40'],['NCCCR']
VC31264293A,30422,57,30470,FAIL,48,['2023-05-15 02:57:45'],['NCR']
VC312642B01,26360,191,26551,FAIL,191,['2023-05-15 18:04:53'],['NCCCCCCCR']
ZA228170936,19622,39,19620,OK,-2,['2023-05-16 12:46:46'],['NCCCCR']
VC310083937,28445,40,28485,FAIL,40,['2023-05-16 15:36:17'],['NCCCCR']
VC312642948,30497,4,30496,OK,-1,['2023-05-17 18:12:09'],['NCRR']
ZA228170934,4829,17,4834,FAIL,5,['2023-05-17 22:00:41'],['NR']
ZA22817093C,9830,12,9825,OK,-5,['2023-05-19 07:22:32'],['NR']
VC31264293L,30415,0,30415,OK,0,['2023-05-19 11:11:45'],['NRR']
ZA228170935,4917,4,4916,OK,-1,['2023-05-19 17:28:24'],['NR']
ZA22817093B,4859,5,4853,OK,-6,['2023-05-19 21:24:12'],['NR']
ZA22817093G,4786,28,4795,FAIL,9,['2023-05-20 03:13:19'],['NCR']
VC312642B03,26514,34,26880,FAIL,366,['2023-09-11 12:31:01'],['NCR']
ZA22817093A,4872,29,4901,FAIL,29,['2023-05-20 12:53:44'],['NRR']
VC312642B04,26545,35,26538,OK,-7,['2023-05-20 20:14:45'],['NR']
ZA22817093E,9691,108,9771,FAIL,80,['2023-05-20 21:24:26'],['NCRR']
VC307335937,30117,12,30119,FAIL,2,['2023-05-21 08:27:40'],['NRR']
VC312642956,30316,88,30384,FAIL,68,['2023-05-22 00:50:00'],['NRR']
VC31264295S,28487,36,28444,OK,-43,['2023-05-22 05:31:08'],['NCRR']
VC312642B06,26700,3,26645,OK,-55,['2023-05-22 16:47:33'],['NR']
VC312642B09,33168,36,33200,FAIL,32,['2023-05-22 20:15:20'],['NCRR']
VC31264295H,23817,25,23785,OK,-32,['2023-05-23 03:14:33'],['NR']
VC31264294U,30473,67,30522,FAIL,49,['2023-05-23 12:22:22'],['NR']
VC30733594Q,28323,71,28323,OK,0,['2023-05-23 15:32:09'],['NR']
VC31264293W,30591,2,30848,FAIL,257,['2023-09-12 02:31:03'],['NCR']
VC312642B10,26532,45,26524,OK,-8,['2023-05-24 08:49:11'],['NR']
VC312642B12,26567,95,26880,FAIL,313,['2023-05-24 12:15:12'],['NCR']
VC307335B05,26613,0,26584,OK,-29,['2023-05-24 19:54:24'],['NR']
VC312642931,11426,1,11427,FAIL,1,['2023-05-25 01:47:57'],['NR']
VC30733593U,22377,0,22337,OK,-40,['2023-05-25 05:49:57'],['NCRR']
VC307335B06,26598,0,26598,OK,0,['2023-05-25 06:16:18'],['NRRR']
VC30733595C,30363,0,30273,OK,-90,['2023-05-25 16:33:54'],['NCR']
VC307335944,29969,12,29951,OK,-18,['2023-05-25 17:19:10'],['NRR']
VC307335B07,26599,7,26601,FAIL,2,['2023-05-26 08:36:06'],['NR']
VC30733594W,28215,0,28214,OK,-1,['2023-05-26 13:46:45'],['NRR']
VC307335B08,26630,7,26627,OK,-3,['2023-05-26 17:36:41'],['NR']
VC312642EA5,28715,1,28710,OK,-5,['2023-05-26 23:45:59'],['NR']
VC312642B19,26348,0,26335,OK,-13,['2023-05-27 02:59:20'],['N']
VC31264295Y,28491,0,28478,OK,-13,['2023-05-27 09:37:45'],['NR']
VC307335956,27068,351,27412,FAIL,344,['2023-05-27 15:39:58'],['NR']
VC31264294J,30375,0,30343,OK,-32,['2023-05-27 19:57:36'],['NR']
VC31008294P,30361,2466,30345,OK,-16,['2023-06-23 07:14:15'],['NRR']
VC31008295C,28378,1819,28366,OK,-12,['2023-06-22 08:52:46'],['NCCCCCCRR']
VC310082EA5,30232,0,30214,OK,-18,['2023-06-14 00:35:03'],['NR']
VC310082B19,26649,4,26646,OK,-3,['2023-06-15 00:02:22'],['NR']
VC310082B20,26668,0,26668,OK,0,['2023-06-15 10:55:14'],['NR']
VC31382693J,28465,14,28367,OK,-98,['2023-06-18 14:30:15'],['NCRR']
VC313826937,28497,0,28481,OK,-16,['2023-06-19 05:28:19'],['NR']
VC310082B24,26605,1656,26594,OK,-11,['2023-06-21 09:05:19'],['NRR']
VC313826B02,26716,17731,26617,OK,-99,['2023-06-23 17:23:52'],['NCCRR']
VC313826956,30489,0,30474,OK,-15,['2023-06-19 14:08:29'],['NR']
VC312642EGA,28542,0,28534,OK,-8,['2023-06-19 17:51:52'],['NRR']
VC313826931,28452,0,28427,OK,-25,['2023-06-19 23:57:23'],['NR']
VC312642EG4,28455,1,28440,OK,-15,['2023-06-24 02:51:16'],['NR']
VC310082EBK,28591,0,28586,OK,-5,['2023-06-20 11:09:16'],['NCCR']
VC310082EBE,28646,0,28646,OK,0,['2023-06-20 23:39:02'],['NR']
VC310082EBU,28649,1830,28643,OK,-6,['2023-07-15 16:52:19'],['NR']
VC31382693V,30643,11,30643,OK,0,['2023-06-21 18:23:00'],['NCRR']
VC313826B03,26702,0,26694,OK,-8,['2023-06-22 00:19:28'],['NR']
VC312642EB6,28348,9,28345,OK,-3,['2023-06-22 13:33:03'],['NCCR']
VC31382693P,28376,0,28364,OK,-12,['2023-06-23 08:19:57'],['NR']
VC312642EBI,29922,0,29920,OK,-2,['2023-06-23 22:31:37'],['NR']
VC313826947,30346,0,30338,OK,-8,['2023-06-24 12:15:13'],['NRR']
VC31382694O,28419,968,28415,OK,-4,['2023-07-06 03:31:32'],['NCR']
VC31382694I,28286,0,28285,OK,-1,['2023-06-25 00:12:16'],['NCR']
VC31391993C,28097,0,28090,OK,-7,['2023-06-25 00:25:39'],['NR']
VC313826B05,26629,0,26622,OK,-7,['2023-06-25 11:24:21'],['NCRR']
VC312642B41,26569,0,26569,OK,0,['2023-06-25 13:54:20'],['NR']
VC313919B01,26587,0,26585,OK,-2,['2023-06-25 22:27:38'],['NCRR']
VC310082EF1,28403,0,28398,OK,-5,['2023-06-26 13:48:49'],['NCCRR']
VC31391993M,28461,0,28461,OK,0,['2023-06-27 21:41:42'],['NR']
VC313919B02,26620,0,26620,OK,0,['2023-06-28 06:24:10'],['NCRR']
VC31391993W,27471,0,27471,OK,0,['2023-06-28 14:53:38'],['NCCRR']
VC313919B03,26711,0,26708,OK,-3,['2023-06-29 00:37:32'],['NRR']
VC31382695H,28559,0,28559,OK,0,['2023-06-29 22:24:18'],['NCCRR']
VC31382695N,28152,0,28144,OK,-8,['2023-06-30 08:40:46'],['NCRR']
VC31391994N,28416,0,28411,OK,-5,['2023-06-30 19:14:26'],['NCR']
VC313919931,30380,0,30376,OK,-4,['2023-07-01 03:37:47'],['NCCRR']
VC313919B04,26572,0,26572,OK,0,['2023-07-01 14:32:47'],['NCCRR']
VC31391994I,28232,0,28232,OK,0,['2023-07-02 01:34:36'],['NCR']
VC31391994Z,28731,0,28727,OK,-4,['2023-07-02 12:27:35'],['NCR']
VC313919956,28586,28422,28402,OK,-184,['2023-07-17 19:50:07'],['NCCR']
VC31391995I,28532,0,28526,OK,-6,['2023-07-02 20:26:22'],['NR']
VC31391994T,28552,0,28552,OK,0,['2023-07-03 03:55:14'],['NRR']
VC31391995C,28360,0,28359,OK,-1,['2023-07-03 11:11:56'],['NCR']
VC313826EAG,28558,0,28791,FAIL,233,['2023-07-03 11:53:53'],['NCRR']
VC31382695S,28479,0,28477,OK,-2,['2023-07-03 20:21:49'],['NR']
VC313919B07,26699,0,26697,OK,-2,['2023-07-04 06:22:54'],['NCR']
VC312642934,28530,0,28530,OK,0,['2023-07-04 17:19:32'],['NCCR']
VC313919947,30545,0,30545,OK,0,['2023-07-05 05:54:12'],['NR']
VC310082942,28558,0,28558,OK,0,['2023-07-05 17:44:44'],['NR']
VC313826EAY,28454,0,28518,FAIL,64,['2023-07-06 19:12:40'],['NCCCR']
VC313826EAS,28398,0,28398,OK,0,['2023-07-08 02:46:50'],['NCR']
VC313826EBN,30427,0,30427,OK,0,['2023-07-08 11:00:00'],['NCR']
VC313826EBB,28596,0,28596,OK,0,['2023-07-08 21:10:36'],['NCCR']
VC313826EBH,28506,0,28506,OK,0,['2023-07-09 05:27:48'],['NCCRR']
VC313826EBY,30442,0,30440,OK,-2,['2023-07-09 15:12:02'],['NCR']
VC313826B24,26744,3,26744,OK,0,['2023-07-09 23:44:02'],['NR']
VC313826EAA,28573,0,28573,OK,0,['2023-07-10 06:36:57'],['NR']
VC313826EB5,28520,0,28518,OK,-2,['2023-07-10 13:46:33'],['NCR']
VC31391995Z,30474,0,30474,OK,0,['2023-07-10 23:42:46'],['NCR']
VC313919B15,26710,0,26710,OK,0,['2023-07-11 07:55:12'],['NR']
VC313826EFA,28529,0,28526,OK,-3,['2023-07-11 14:32:07'],['NR']
VC31391995O,30473,0,30472,OK,-1,['2023-07-11 21:56:18'],['NR']
VC313919B16,26738,0,26738,OK,0,['2023-07-12 06:16:22'],['NCR']
VC313919EAB,27428,0,27428,OK,0,['2023-07-15 08:05:10'],['NR']
VC313919B17,26518,0,26516,OK,-2,['2023-07-12 22:49:47'],['NCCR']
VC313919B20,26680,0,26680,OK,0,['2023-07-13 19:09:19'],['NCRR']
VC313919EAL,30128,0,30128,OK,0,['2023-07-14 03:39:28'],['NCRR']
VC314175955,27397,0,27388,OK,-9,['2023-07-16 02:35:18'],['NR']
VC31417593V,28453,0,28447,OK,-6,['2023-07-16 09:54:25'],['NR']
VC31417593D,28469,0,28460,OK,-9,['2023-07-16 19:57:10'],['NCCR']
VC31417593P,28488,0,28480,OK,-8,['2023-07-17 04:05:58'],['NCR']
VC319524B01,26731,0,26725,OK,-6,['2023-07-17 11:32:09'],['NR']
VC319524931,30516,0,30513,OK,-3,['2023-07-18 04:18:48'],['NCR']
VC31417593J,28537,0,28535,OK,-2,['2023-07-18 15:01:35'],['NCCCR']
VC314175937,28512,0,28512,OK,0,['2023-07-19 01:27:42'],['NCR']
VC313919B30,26756,0,26739,OK,-17,['2023-07-19 08:50:28'],['NR']
VC314175B01,26775,0,26772,OK,-3,['2023-07-19 15:54:29'],['NCR']
VC313919EAW,25363,0,25363,OK,0,['2023-07-19 23:45:08'],['NR']
VC31417594I,30514,0,30502,OK,-12,['2023-07-20 06:23:45'],['NCR']
VC313919EB7,28628,0,28628,OK,0,['2023-07-20 15:25:30'],['NR']
VC314175B06,26689,0,26689,OK,0,['2023-07-20 23:45:41'],['NR']
VC31417594T,30298,0,30298,OK,0,['2023-07-21 06:36:20'],['NCCCR']
VC314175942,27239,361,27138,OK,-101,['2023-07-23 12:19:07'],['NCCR']
VC31952494G,28599,0,28599,OK,0,['2023-07-21 23:49:06'],['NRR']
VC31952495B,28451,0,28444,OK,-7,['2023-07-22 07:34:18'],['NRR']
VC31952493C,30530,0,30528,OK,-2,['2023-07-22 15:54:06'],['NR']
VC31952494A,28671,28407,28423,OK,-248,['2023-07-24 04:25:05'],['NR']
VC319524B05,26728,0,26723,OK,-5,['2023-07-23 21:00:52'],['NCR']
VC31952494M,28487,90,28574,FAIL,87,['2023-07-27 21:50:42'],['NR']
VC31952495Z,28555,15,28570,FAIL,15,['2023-07-27 13:17:59'],['NCR']
VC319524955,28452,0,28452,OK,0,['2023-07-25 07:27:55'],['NR']
VC31952494Y,28574,0,28553,OK,-21,['2023-07-25 21:26:22'],['NR']
VC31952495N,28510,0,28509,OK,-1,['2023-07-26 06:30:14'],['NCCR']
VC31952495T,28565,0,28559,OK,-6,['2023-07-26 18:07:41'],['NR']
VC31952493Y,30231,0,30199,OK,-32,['2023-07-27 02:57:19'],['NRR']
VC31952495Z,28431,22,28448,FAIL,17,['2023-07-27 13:17:59'],['NCR']
VC31952494M,28486,0,28486,OK,0,['2023-07-27 21:50:42'],['NR']
VC31952494S,28528,2,28514,OK,-14,['2023-07-28 07:26:06'],['NR']
VC319524B10,26651,0,26648,OK,-3,['2023-07-28 17:44:38'],['NRR']
VC319524EAU,28579,0,28576,OK,-3,['2023-07-29 02:36:06'],['NCCR']
VC319524EA6,28433,0,28432,OK,-1,['2023-07-29 11:51:54'],['NR']
VC319524EBD,28447,0,28438,OK,-9,['2023-07-29 20:12:24'],['NCCR']
VC319524EAI,28469,0,28469,OK,0,['2023-07-30 05:28:28'],['NCCR']
VC31952495H,28417,0,28400,OK,-17,['2023-07-30 14:26:08'],['NCR']
VC319524EBV,30253,0,30248,OK,-5,['2023-07-30 23:52:46'],['NCCR']
VC319524B12,26602,0,26599,OK,-3,['2023-07-31 08:29:06'],['NR']
VC319524EBJ,28537,0,28536,OK,-1,['2023-07-31 15:47:40'],['NR']
VC31952493N,30301,63,30301,OK,0,['2023-07-31 17:07:06'],['NCCCCR']
VC319524B11,26678,0,26678,OK,0,['2023-07-31 23:32:39'],['NR']
VC319524EAC,28413,0,28413,OK,0,['2023-08-01 06:43:04'],['NR']
VC319524EB7,28381,0,28365,OK,-16,['2023-08-01 12:30:31'],['NRR']
VC319524B13,26712,0,26712,OK,0,['2023-08-01 14:56:41'],['NCR']
VC319524EBP,28376,0,28373,OK,-3,['2023-08-01 23:50:06'],['NR']
VC319524EF7,30273,15,30235,OK,-38,['2023-08-02 00:12:05'],['NCR']
VC319524B14,26680,0,26679,OK,-1,['2023-08-02 07:31:00'],['NR']
VC319524EFT,30483,0,30481,OK,-2,['2023-08-02 13:29:04'],['NCRR']
VC319524EAO,28412,0,28411,OK,-1,['2023-08-02 18:12:01'],['NCR']
VC313919EBJ,23931,0,23930,OK,-1,['2023-08-03 02:22:10'],['NR']
VC313919EBD,28299,0,28299,OK,0,['2023-08-03 02:27:04'],['NCR']
VC314175931,28601,0,28601,OK,0,['2023-08-03 12:53:35'],['NCCR']
VC31417595L,30502,0,30500,OK,-2,['2023-08-04 01:01:08'],['NCR']
VC320779953,30385,0,30384,OK,-1,['2023-08-04 13:42:19'],['NCR']
VC314175B11,26747,0,26747,OK,0,['2023-08-05 02:14:21'],['NCR']
VC320779B01,26664,0,26654,OK,-10,['2023-08-05 13:09:48'],['NR']
VC31382693D,28514,0,28514,OK,0,['2023-08-05 22:54:35'],['NCCRR']
VC320779945,30262,0,30260,OK,-2,['2023-08-06 11:46:02'],['NR']
VC319524EGG,30449,8,30447,OK,-2,['2023-08-06 21:41:53'],['NCR']
VC319524EB1,28412,1,28412,OK,0,['2023-08-08 18:10:07'],['NCCCRR']
VC319524B35,26542,3,26530,OK,-12,['2023-08-09 15:58:59'],['NCCR']
VC32077994G,30235,20,30229,OK,-6,['2023-08-10 08:35:13'],['NCCR']
ZA22817093H,9700,32,9626,OK,-74,['2023-08-10 09:05:42'],['NR']
ZA22817093J,9681,99,9765,FAIL,84,['2023-11-06 14:49:13'],['NCCR']
ZA22817093M,4824,52,4804,OK,-20,['2023-08-11 04:43:45'],['NR']
VC320779B02,26720,21,26693,OK,-27,['2023-08-11 05:51:26'],['NR']
ZA22817093L,4830,41,4791,OK,-39,['2023-08-11 10:49:06'],['NR']
VC320779B03,26725,4,26586,OK,-139,['2023-08-11 16:10:44'],['NR']
VC32077995W,28554,12,28543,OK,-11,['2023-08-12 05:13:57'],['NCR']
VC32077993Y,28089,56,28105,FAIL,16,['2023-08-27 02:18:52'],['NR']
VC320779EA3,28527,9,28536,FAIL,9,['2023-08-27 19:55:07'],['NCRR']
VC319524B42,33288,36,33274,OK,-14,['2023-08-14 02:45:12'],['NCCR']
VC319524EG5,30439,25,30431,OK,-8,['2023-08-14 18:00:59'],['NCRRR']
VC319524EGR,23710,1,23710,OK,0,['2023-08-14 19:09:12'],['NCR']
VC32108893O,30519,0,30515,OK,-4,['2023-08-15 05:30:57'],['NRR']
VC321088931,28582,0,28560,OK,-22,['2023-08-15 13:49:36'],['NRR']
VC32108893D,30376,0,30370,OK,-6,['2023-08-15 16:23:04'],['NR']
VC32077993C,30133,1,30133,OK,0,['2023-08-16 02:40:56'],['NR']
VC319524EH3,30102,2,30100,OK,-2,['2023-08-16 05:37:31'],['NR']
VC32077993N,30349,12,30349,OK,0,['2023-08-16 13:28:28'],['NCR']
VC320779931,30364,44,30330,OK,-34,['2023-08-16 22:05:42'],['NCRR']
VC319524B43,26632,0,26630,OK,-2,['2023-08-17 07:04:56'],['NR']
VC327909931,28537,35,28536,OK,-1,['2023-08-17 17:22:21'],['NCR']
VC319524B44,26584,89,26578,OK,-6,['2023-08-17 18:17:27'],['NCCR']
VC321088B01,26726,0,26726,OK,0,['2023-08-18 09:20:25'],['NR']
VC32108895Y,28439,0,28439,OK,0,['2023-08-18 17:46:37'],['NR']
VC320779B11,26710,0,26696,OK,-14,['2023-08-18 23:40:22'],['NR']
VC320779B13,26701,0,26701,OK,0,['2023-08-19 04:04:45'],['NR']
VC320779B12,26649,0,26649,OK,0,['2023-08-19 07:34:02'],['NR']
VC321088B02,26649,0,26648,OK,-1,['2023-08-18 14:21:02'],['NR']
VC32790993C,28456,0,28456,OK,0,['2023-08-19 13:26:03'],['NR']
VC321088B04,33133,199,33332,FAIL,199,['2023-08-28 07:46:07'],['NCCCCCR']
VC321088937,28330,0,28318,OK,-12,['2023-08-19 22:37:32'],['NR']
VC32790993T,28313,0,28310,OK,-3,['2023-08-20 01:35:55'],['NR']
VC32108893Z,23573,172,23738,FAIL,165,['2023-08-29 01:25:19'],['NCR']
VC327909937,27762,0,27761,OK,-1,['2023-08-20 10:29:06'],['NR']
VC32108895S,28412,2,28400,OK,-12,['2023-08-20 16:29:49'],['NCR']
VC32108895M,28595,0,28593,OK,-2,['2023-08-20 19:53:32'],['NR']
VC319524EHE,28422,28,28450,FAIL,28,['2023-08-27 20:50:50'],['NR']
VC32790993N,28476,0,28476,OK,0,['2023-08-21 03:47:00'],['NRR']
VC32790993H,28562,0,28562,OK,0,['2023-08-21 05:13:30'],['NRR']
VC32108894B,30465,0,30465,OK,0,['2023-08-21 12:12:33'],['NR']
VC32108894M,30408,0,30400,OK,-8,['2023-08-21 15:14:25'],['NR']
VC32108895G,28535,0,28515,OK,-20,['2023-08-21 21:45:57'],['NR']
VC321088B08,26707,0,26707,OK,0,['2023-08-22 01:57:26'],['NR']
VC321088B09,26710,0,26697,OK,-13,['2023-08-22 07:46:00'],['NCR']
VC321088EA5,28402,0,28402,OK,0,['2023-08-22 10:46:05'],['NR']
VC32077995E,28636,0,28635,OK,-1,['2023-08-22 16:11:51'],['NR']
VC32108895A,28625,0,28623,OK,-2,['2023-08-22 20:13:26'],['NR']
VC32077995Q,28579,0,28579,OK,0,['2023-08-23 01:50:55'],['NCR']
VC327909945,28561,0,28561,OK,0,['2023-08-23 06:05:59'],['NCR']
VC32790993Y,28578,0,28578,OK,0,['2023-08-23 17:25:35'],['NR']
VC32077995K,28411,0,28410,OK,-1,['2023-08-23 17:00:19'],['NRR']
VC321088EB6,28553,0,28553,OK,0,['2023-08-24 03:02:57'],['NCR']
VC321088EAZ,28468,0,28468,OK,0,['2023-08-24 22:38:00'],['NR']
VC32108894X,28619,0,28604,OK,-15,['2023-08-25 02:13:30'],['NR']
VC310083B03,26656,0,26651,OK,-5,['2023-08-24 15:17:10'],['NR']
VC32790994T,28504,0,28504,OK,0,['2023-08-25 09:09:13'],['NR']
VC32790994N,28576,0,28576,OK,0,['2023-08-25 10:55:56'],['NR']
VC321088EAH,28625,0,28625,OK,0,['2023-08-25 20:09:27'],['NR']
VC310083EG2,25962,0,25961,OK,-1,['2023-08-24 05:08:00'],['NR']
VC32790994H,28489,0,28483,OK,-6,['2023-08-25 20:13:22'],['NCR']
VC30733595Z,28415,0,28415,OK,0,['2023-08-26 04:52:34'],['NR']
VC30733595T,27759,0,27758,OK,-1,['2023-08-26 05:49:09'],['NR']
VC307335EAL,20563,0,20563,OK,0,['2023-08-26 16:36:15'],['NCR']
VC30733595N,28371,0,28291,OK,-80,['2023-08-26 18:40:34'],['NCRR']
VC321088B19,26671,0,26669,OK,-2,['2023-08-27 11:24:13'],['NCR']
VC321088EBN,30460,0,30460,OK,0,['2023-08-27 08:42:07'],['NCCR']
VC32790994B,28511,0,28506,OK,-5,['2023-08-28 05:51:50'],['NCRR']
VC32790994Z,28428,0,28428,OK,0,['2023-08-28 17:03:58'],['NR']
VC321088B04,32889,199,33083,FAIL,194,['2023-08-28 07:46:07'],['NCCCCCR']
VC32108893Z,23480,170,23649,FAIL,169,['2023-08-29 01:25:19'],['NCR']
VC320779EA3,28373,19,28364,OK,-9,['2023-08-27 19:55:07'],['NCRR']
VC32077993Y,28012,0,27998,OK,-14,['2023-08-27 02:18:52'],['NR']
VC319524EHE,28370,1,28371,FAIL,1,['2023-08-27 20:50:50'],['NR']
VC321088B04,32889,199,33083,FAIL,194,['2023-08-28 07:46:07'],['NCCCCCR']
VC32108893Z,23480,170,23649,FAIL,169,['2023-08-29 01:25:19'],['NCR']
VC321088EGE,28532,0,28532,OK,0,['2023-08-29 05:25:38'],['NCR']
VC321088EFA,30515,0,30498,OK,-17,['2023-08-29 10:59:11'],['NCR']
VC321088B23,26680,0,26679,OK,-1,['2023-08-29 19:06:35'],['NR']
VC32790995R,23842,1,23838,OK,-4,['2023-08-29 20:43:28'],['NRR']
VC321088B04,32889,199,33083,FAIL,194,['2023-08-28 07:46:07'],['NCCCCCR']
VC32108893Z,23480,170,23649,FAIL,169,['2023-08-29 01:25:19'],['NCR']
VC327909B09,33303,12,33301,OK,-2,['2023-08-30 06:53:08'],['NCRR']
VC327909B10,26644,0,26641,OK,-3,['2023-08-30 20:15:17'],['NR']
VC327909EA3,30471,4,30471,OK,0,['2023-08-30 20:40:27'],['NCR']
VC327909955,30546,0,30514,OK,-32,['2023-08-31 06:47:57'],['NR']
VC321088EAN,28632,0,28632,OK,0,['2023-08-31 06:19:59'],['NR']
VC321088EAT,28538,0,28537,OK,-1,['2023-08-31 19:11:26'],['NR']
VC321088EFL,28659,0,28659,OK,0,['2023-09-01 01:40:20'],['NR']
VC321088EAB,28252,0,28252,OK,0,['2023-08-30 06:21:07'],['NCR']
VC321088EBY,30439,0,30437,OK,-2,['2023-09-01 05:26:41'],['NR']
VC327909EB1,26872,1,26871,OK,-1,['2023-08-31 16:57:08'],['NRR']
VC321088EBC,30445,0,30444,OK,-1,['2023-09-01 11:42:26'],['NCR']
VC327909B12,26671,0,26671,OK,0,['2023-09-01 16:32:10'],['NR']
VC321088EFR,30503,0,30503,OK,0,['2023-09-01 22:46:33'],['NR']
VC321088B25,26688,0,26688,OK,0,['2023-09-02 02:23:53'],['NR']
VC321088B29,26634,0,26634,OK,0,['2023-09-02 09:13:54'],['NR']
VC321088EG3,30543,0,30543,OK,0,['2023-09-02 12:49:13'],['NR']
VC327909EAE,30512,0,30512,OK,0,['2023-09-02 18:35:23'],['NR']
VC321088B26,26737,0,26730,OK,-7,['2023-09-02 23:17:04'],['NR']
VC321088B31,26712,0,26711,OK,-1,['2023-09-03 05:08:53'],['NR']
VC327909B15,26692,0,26692,OK,0,['2023-09-03 14:32:54'],['NRR']
VC310083942,30340,1,30338,OK,-2,['2023-09-03 09:45:10'],['NCCR']
VC327909EFQ,28595,0,28594,OK,-1,['2023-09-03 23:51:46'],['NR']
VC327909EFV,30568,0,30568,OK,0,['2023-09-04 00:13:25'],['NR']
VC32790995G,30346,0,30328,OK,-18,['2023-09-04 20:07:04'],['NCCR']
VC321088954,28412,0,28412,OK,0,['2023-09-04 22:19:45'],['NR']
VC327909EB6,33362,0,33362,OK,0,['2023-09-05 07:30:41'],['NR']
VC327909B22,33379,0,33379,OK,0,['2023-09-05 19:10:47'],['NRR']
VC327909B21,26695,0,26694,OK,-1,['2023-09-06 07:14:30'],['NCR']
VC328137937,28612,0,28606,OK,-6,['2023-09-06 22:08:59'],['NCCR']
VC32813793P,28620,0,28614,OK,-6,['2023-09-07 04:55:13'],['NR']
VC328137931,28621,0,28615,OK,-6,['2023-09-07 08:54:25'],['NR']
VC328137942,28656,0,28656,OK,0,['2023-09-07 19:23:55'],['NR']
VC32813793V,28477,0,28471,OK,-6,['2023-09-08 01:33:07'],['NR']
VC327909EBH,28582,38,28579,OK,-3,['2023-09-08 14:19:04'],['NCCCCRR']
VC32813794W,28572,0,28572,OK,0,['2023-09-09 05:48:37'],['NCCRR']
VC32813793J,28559,0,28559,OK,0,['2023-09-09 17:58:20'],['NCR']
VC327909EG7,28460,5,28459,OK,-1,['2023-09-09 13:31:56'],['NCRR']
VC327909EFF,30324,23,30311,OK,-13,['2023-09-11 08:26:51'],['NCRR']
VC32813795V,28442,10,28440,OK,-2,['2023-09-13 03:05:36'],['NR']
VC328137EA8,30441,0,30441,OK,0,['2023-09-13 23:33:46'],['NRR']
VC328137EBH,28237,1,28235,OK,-2,['2023-09-14 21:30:51'],['NR']
VC328137B08,26661,6,26651,OK,-10,['2023-09-17 14:56:16'],['NR']
VC327909EF4,30516,0,30516,OK,0,['2023-09-04 09:17:54'],['NCR']
VC32813793D,28674,0,28674,OK,0,['2023-09-07 15:52:34'],['NR']
VC327909EAP,23850,0,23850,OK,0,['2023-09-04 10:37:55'],['NRR']
VC327909EGD,26763,0,26763,OK,0,['2023-09-13 13:44:11'],['NRR']
VC32813794E,28406,1,28391,OK,-15,['2023-09-10 07:08:15'],['NCRR']
VC32813794K,28203,0,28203,OK,0,['2023-09-10 15:51:49'],['NCRR']
VC328137EB6,30216,170,30361,FAIL,145,['2023-09-26 05:51:58'],['NRR']
VC32813794Q,28469,0,28444,OK,-25,['2023-09-08 05:44:25'],['NCR']
VC328137948,28460,0,28460,OK,0,['2023-09-08 19:50:07'],['NCR']
VC328137EAJ,30249,1,30248,OK,-1,['2023-09-18 06:42:30'],['NCR']
VC328137EA2,28463,0,28463,OK,0,['2023-09-15 11:16:22'],['NCCR']
VC328137EAU,30451,0,30451,OK,0,['2023-09-18 20:34:37'],['NR']
VC328137EF5,30581,0,30581,OK,0,['2023-09-19 07:56:06'],['NR']
VC327910937,30581,0,30572,OK,-9,['2023-09-19 11:46:00'],['NR']
VC328137B12,26689,0,26689,OK,0,['2023-09-19 19:03:54'],['NCR']
VC32813795E,30365,11,30365,OK,0,['2023-09-20 00:12:53'],['NCR']
VC328137B16,26707,0,26703,OK,-4,['2023-09-20 11:40:39'],['NR']
VC328137B11,26506,0,26486,OK,-20,['2023-09-20 05:16:38'],['NCCCCRR']
VC328137EBT,30611,0,30611,OK,0,['2023-09-20 21:36:34'],['NR']
VC327909B34,26677,0,26650,OK,-27,['2023-09-20 22:01:34'],['NCR']
VC328137B13,26672,0,26672,OK,0,['2023-09-21 09:21:21'],['NR']
VC328137EBN,28336,5,28335,OK,-1,['2023-09-21 12:31:35'],['NCCRR']
VC328137EFG,30457,0,30453,OK,-4,['2023-09-21 20:58:03'],['NR']
VC328137EFR,30594,0,30593,OK,-1,['2023-09-22 03:48:37'],['NR']
VC328137B19,26677,3,26677,OK,0,['2023-09-22 14:13:25'],['NCCR']
VC327910931,28418,3,28396,OK,-22,['2023-09-18 20:09:00'],['NCCRR']
VC327910B01,26656,0,26647,OK,-9,['2023-09-23 03:52:23'],['NCRR']
VC32791093T,28631,0,28629,OK,-2,['2023-09-22 22:06:35'],['NR']
VC328137B23,26713,0,26713,OK,0,['2023-09-24 03:12:59'],['NCR']
VC32791094X,28621,0,28587,OK,-34,['2023-09-23 22:36:26'],['NCRR']
VC32791093I,30285,0,30285,OK,0,['2023-09-24 14:06:58'],['NRR']
VC33380993U,28505,0,28498,OK,-7,['2023-09-25 05:01:42'],['NCCCRR']
VC32791095G,28505,1,28496,OK,-9,['2023-09-25 15:25:23'],['NCCCRR']
VC328137B25,26628,0,26627,OK,-1,['2023-09-22 08:54:23'],['NCR']
VC333809931,24823,0,24820,OK,-3,['2023-09-26 12:00:50'],['NR']
VC327910B05,26578,0,26540,OK,-38,['2023-09-26 21:35:39'],['NR']
VC327910954,28551,0,28537,OK,-14,['2023-09-26 21:53:36'],['NRR']
VC33380993C,28642,0,28626,OK,-16,['2023-09-27 07:38:32'],['NR']
VC333809936,28606,10,28604,OK,-2,['2023-09-27 11:14:11'],['NCRR']
VC33380994D,28662,0,28661,OK,-1,['2023-09-27 18:14:27'],['NR']
VC33380993O,28577,0,28573,OK,-4,['2023-09-28 04:06:10'],['NRR']
VC33380993I,28614,0,28610,OK,-4,['2023-09-29 04:46:41'],['NR']
VC328137953,30007,0,30006,OK,-1,['2023-09-29 07:03:03'],['NCRR']
VC33380994J,28464,13,28460,OK,-4,['2023-09-29 17:19:49'],['NCR']
VC333809941,28570,0,28566,OK,-4,['2023-09-30 03:10:39'],['NCR']
VC333809947,28711,0,28706,OK,-5,['2023-09-30 04:12:21'],['NR']
VC32952893F,18223,0,18223,OK,0,['2023-10-01 01:23:54'],['NR']
VC328137B41,26596,0,26596,OK,0,['2023-09-30 23:49:39'],['NCR']
VC329528931,18210,0,18209,OK,-1,['2023-10-01 09:48:10'],['NR']
VC328137EB6,30210,1,30179,OK,-31,['2023-09-26 05:51:58'],['NRR']
VC327909EBN,28329,0,28329,OK,0,['2023-10-02 20:12:52'],['NCR']
VC32813795P,28521,0,28520,OK,-1,['2023-09-28 17:34:46'],['NCR']
VC329528935,28542,0,28541,OK,-1,['2023-10-07 05:33:03'],['NCR']
VC329528B03,26624,0,26624,OK,0,['2023-10-08 02:15:48'],['NR']
VC32791095M,28577,13,28558,OK,-19,['2023-09-30 13:31:42'],['NR']
VC333809EAG,30455,12,30453,OK,-2,['2023-10-10 21:15:04'],['NRR']
VC333809B14,26623,0,26611,OK,-12,['2023-10-11 08:31:16'],['NR']
VC327909B19,26707,0,26707,OK,0,['2023-10-12 03:14:39'],['NCR']
VC329528958,28376,18,28355,OK,-21,['2023-10-14 10:17:52'],['NR']
VC329528953,25673,0,25673,OK,0,['2023-10-14 23:04:54'],['NR']
VC32952894C,30714,0,30714,OK,0,['2023-10-15 08:02:45'],['NR']
VC33410494Y,28664,0,28663,OK,-1,['2023-10-15 18:18:56'],['NR']
VC33410494B,28529,8,28503,OK,-26,['2023-10-16 03:42:50'],['NRR']
VC33410494N,28224,0,28224,OK,0,['2023-10-16 13:57:59'],['NR']
VC33410493N,28524,2,28500,OK,-24,['2023-10-15 15:02:39'],['NR']
VC334104936,26453,0,26453,OK,0,['2023-10-16 16:49:25'],['NCRR']
VC33410493H,28636,0,28636,OK,0,['2023-10-16 03:30:34'],['NCR']
VC334104931,26068,0,26068,OK,0,['2023-10-16 23:07:15'],['NRR']
VC32952894Y,22184,0,22181,OK,-3,['2023-10-17 02:50:19'],['NR']
VC329528B07,26680,0,26680,OK,0,['2023-10-17 07:31:52'],['NCR']
VC33410493B,28587,0,28587,OK,0,['2023-10-17 10:55:48'],['NR']
VC329528B08,33360,0,33360,OK,0,['2023-10-17 16:04:37'],['NR']
VC32952894N,27355,0,27355,OK,0,['2023-10-18 02:45:54'],['NR']
VC32952893N,32642,0,32634,OK,-8,['2023-10-18 00:30:17'],['NR']
VC32952893J,17821,0,17821,OK,0,['2023-10-11 18:52:54'],['NRR']
VC33410495B,28416,0,28415,OK,-1,['2023-10-18 11:53:14'],['NR']
VC329528B09,33415,0,33408,OK,-7,['2023-10-18 13:02:38'],['NR']
VC334104955,28546,0,28546,OK,0,['2023-10-18 21:19:46'],['NR']
VC33410493T,30539,0,30538,OK,1,['2023-10-19 06:32:20'],['NR']
VC33410494T,27217,0,27205,OK,12,['2023-10-19 04:15:36'],['NCCR']
VC334104B01,26693,0,26681,OK,12,['2023-10-19 16:13:03'],['NR']
VC32952893Z,33881,1,33881,OK,0,['2023-10-19 19:09:24'],['NCR']
VC329528B10,33383,0,33359,OK,24,['2023-10-20 01:51:29'],['NR']
VC312642S08,24818,0,24798,OK,20,['2023-10-26 20:18:42'],['NCCRR']
VC307335S06,24709,28,24695,OK,14,['2023-10-27 08:48:11'],['NCCCCRR']
VC307335S07,17234,1,17230,OK,4,['2023-10-28 02:57:28'],['NCCCRR']
VC310083S24,7387,0,7385,OK,2,['2023-10-28 13:40:23'],['NCCRR']
VC312642S07,27293,0,27291,OK,2,['2023-10-28 21:52:51'],['NCRR']
VC334104B15,26655,1,26631,OK,24,['2023-10-29 05:25:53'],['NCR']
VC310083S26,18718,4,18718,OK,0,['2023-10-29 15:15:57'],['NCR']
VC312642S09,2481,0,2481,OK,0,['2023-10-30 00:11:45'],['NCR']
VC310083S25,498,0,498,OK,0,['2023-10-30 02:01:06'],['NR']
VC32077994R,30042,0,30020,OK,22,['2023-08-12 06:04:38'],['NR']
VC334104EB3,30487,0,30486,OK,1,['2023-10-29 21:49:43'],['NR']
VC312642S06,29691,0,29657,OK,34,['2023-10-30 02:26:22'],['NR']
VC334104EA6,26230,0,26190,OK,40,['2023-10-30 12:17:59'],['NR']
VC34131593N,30470,5,30460,OK,10,['2023-10-30 16:20:26'],['NRR']
VC33410495V,25624,0,25623,OK,1,['2023-10-31 01:21:52'],['NR']
VC341315B01,26624,0,26623,OK,1,['2023-10-31 05:11:58'],['NCRR']
VC334104B17,26704,0,26704,OK,0,['2023-10-31 12:24:11'],['NR']
VC334104B19,26565,0,26565,OK,0,['2023-11-01 00:09:35'],['NR']
VC334104EAL,24828,0,24826,OK,2,['2023-11-01 09:50:29'],['NRR']
VC334104EBE,43609,10,43605,OK,4,['2023-11-01 11:49:37'],['NCCRR']
VC33410495R,22756,0,22756,OK,0,['2023-11-02 07:54:45'],['NRR']
VC33410495H,24661,0,24661,OK,0,['2023-11-02 17:37:11'],['NRR']
VC341315931,30048,0,30023,OK,25,['2023-11-02 23:31:40'],['NRR']
VC342456944,24167,3,24167,OK,0,['2023-11-03 05:45:56'],['NRR']
VC34131595J,28573,42,28558,OK,15,['2023-11-03 15:02:56'],['NR']
VC334104EAW,28421,1,28421,OK,0,['2023-11-03 15:26:11'],['NRR']
VC34131593Y,30356,0,30348,OK,8,['2023-11-04 03:55:32'],['NCR']
VC34245694E,28534,2,28535,FAIL,1,['2023-11-04 02:32:30'],['NCR']
VC341315EA1,28562,0,28562,OK,0,['2023-11-04 13:25:36'],['NR']
VC334104EAQ,28538,0,28535,OK,3,['2023-11-04 13:51:38'],['NRR']
VC341315958,30454,0,30447,OK,7,['2023-11-04 23:00:48'],['NCCR']
VC34131595P,30520,0,30520,OK,0,['2023-11-05 02:39:55'],['NRR']
VC341315B03,26617,0,26617,OK,0,['2023-11-05 11:14:40'],['NR']
VC34131594A,30593,0,30593,OK,0,['2023-11-05 13:55:00'],['NRR']
VC34131594L,30513,0,30513,OK,0,['2023-11-05 20:03:28'],['NR']
VC341315B02,26647,0,26647,OK,0,['2023-11-05 23:58:52'],['NRR']
VC34131594W,30497,0,30483,OK,14,['2023-11-06 06:11:25'],['NCR']
VC342456949,24229,0,24229,OK,0,['2023-11-06 09:42:55'],['NR']
VC334104B32,26616,0,26615,OK,1,['2023-11-06 16:06:24'],['NCR']
ZA22817093J,9709,10,9704,OK,5,['2023-11-06 14:49:13'],['NCCR']
VC34131593C,30008,0,30008,OK,0,['2023-11-06 17:58:30'],['NRR']
ZA22817093O,4864,5,4851,OK,13,['2023-11-06 23:39:03'],['NCRR']
VC341315B05,26620,0,26620,OK,0,['2023-11-07 00:08:23'],['NR']
ZA22817093N,4820,26,4796,OK,24,['2023-11-07 06:02:19'],['NRR']
VC341315B06,26625,0,26625,OK,0,['2023-11-07 07:48:32'],['NR']
VC341315B04,26597,0,26588,OK,9,['2023-11-07 05:15:32'],['NRR']
VC334104EAB,24635,11,24622,OK,13,['2023-11-07 15:14:15'],['NR']
VC341315B14,26644,0,26643,OK,1,['2023-11-07 16:50:46'],['NRR']
VC341315B09,26572,0,26572,OK,0,['2023-11-07 22:44:52'],['NR']
VC341315B07,26629,0,26629,OK,0,['2023-11-08 03:52:27'],['NR']
VC34245694E,28426,0,28426,OK,0,['2023-11-08 07:24:11'],['NCRR']
VC34245694K,28426,0,28402,OK,24,['2023-11-08 21:52:09'],['NCR']
ZA22817093P,4867,11,4864,OK,3,['2023-11-07 12:12:06'],['NR']
VC341315EA7,28424,0,28407,OK,17,['2023-11-09 07:37:10'],['NR']
VC33410494H,28520,0,28512,OK,8,['2023-10-15 02:14:47'],['NR']
VC32791093Z,29817,1,29779,OK,38,['2023-09-23 09:28:31'],['NRR']
VC327910B04,26518,0,26509,OK,9,['2023-09-25 21:51:26'],['NCRR']
VC33380995D,21070,0,21063,OK,7,['2023-10-05 22:35:37'],['NCCCCR']
VC333809957,27205,0,27205,OK,0,['2023-10-06 03:53:56'],['NCCR']
VC333809EA5,28822,15,28820,OK,2,['2023-10-06 16:33:32'],['NCCCR']
VC327910B06,26252,21,26253,FAIL,1,['2023-09-28 17:19:47'],['NCCRR']
VC33380994P,27502,0,27502,OK,0,['2023-09-30 14:01:24'],['NCR']
VC32791094B,30163,0,30146,OK,17,['2023-09-30 14:01:24'],['NCCRR']
VC327910B03,25995,6,25955,OK,40,['2023-09-23 16:02:01'],['NRR']
VC333809B11,24730,0,24723,OK,7,['2023-10-06 03:53:56'],['NCCR']
VC33380994V,28134,0,28134,OK,0,['2023-10-01 10:21:00'],['NRR']
VC34245695E,30467,0,30463,OK,4,['2023-11-13 19:42:52'],['NCCRR']
VC342456953,30408,0,30402,OK,6,['2023-11-14 08:29:55'],['NCCCCRR']
VC342456B08,26597,5,26580,OK,17,['2023-11-15 06:07:20'],['NCRR']
VC34245695P,28460,0,28454,OK,6,['2023-11-15 18:30:08'],['NR']
VC34245694W,28606,2,28596,OK,10,['2023-11-16 07:14:41'],['NCCCRR']
VC342456B07,26620,0,26620,OK,0,['2023-11-16 20:20:13'],['NR']
VC328137EG3,27045,0,27010,OK,35,['2023-09-24 14:40:39'],['NCCRR']
VC34245693J,24147,12,24123,OK,24,['2023-11-20 20:03:35'],['NR']
VC342456B16,26590,0,26588,OK,2,['2023-11-21 16:39:33'],['NR']
VC333809B16,20643,55,20575,OK,68,['2023-11-01 19:15:47'],['NCCCCCCRR']
VC342456EBS,30589,0,30581,OK,8,['2023-11-22 02:30:29'],['NCCRRR']
VC333809952,19196,2,19125,OK,71,['2023-10-01 16:32:51'],['NCCCCRR']
VC342456B18,26681,0,26673,OK,8,['2023-11-23 05:46:41'],['NR']
VC341315EFG,28554,0,28511,OK,43,['2023-11-22 20:39:59'],['NRR']
VC310082B13,2160,0,2160,OK,0,['2023-11-24 02:51:40'],['NRR']
VC342456B17,26611,20,26611,OK,0,['2023-11-22 19:15:20'],['NR']
VC342456EFF,30477,15,30472,OK,5,['2023-11-23 07:55:30'],['NRR']
VC342456B19,26639,0,26628,OK,11,['2023-11-24 04:38:16'],['NRR']
VC33380995J,18477,0,18474,OK,3,['2023-10-31 21:43:17'],['NCCCCRR']
VC33380995U,23770,3,23750,OK,20,['2023-10-04 15:01:35'],['NCCCRR']
VC333809B12,24841,5,24830,OK,11,['2023-10-07 17:46:51'],['NCCCR']
VC342456EBM,28418,43,28416,OK,2,['2023-11-24 17:50:05'],['NCCRR']
VC342456EB5,30298,0,30274,OK,24,['2023-11-22 03:27:11'],['NCCR']
VC334104945,28603,0,28571,OK,32,['2023-11-24 03:14:07'],['NR']
VC341315EFA,28209,250,28441,FAIL,232,['2023-11-25 10:02:53'],['NRRR']
VC34245693O,24035,0,24018,OK,17,['2023-11-26 09:41:38'],['NRR']
VC34245693A,21623,19,21620,OK,3,['2023-11-27 00:43:27'],['NCR']
VC32791095A,26402,8,26663,FAIL,261,['2023-11-23 17:05:01'],['NR']
VC341315EAO,30349,0,30349,OK,0,['2023-11-27 17:33:37'],['NR']
VC342456931,21358,0,21357,OK,1,['2023-11-28 07:18:47'],['NR']
VC341315B34,26627,0,26625,OK,2,['2023-11-28 17:42:12'],['NR']
VC341315EAD,30117,0,30106,OK,11,['2023-11-29 05:13:36'],['NCR']
VC342456B33,26636,0,26634,OK,2,['2023-11-30 00:02:51'],['NR']
VC342456B30,26629,0,26629,OK,0,['2023-11-30 10:05:33'],['NR']
VC341315B33,26563,0,26562,OK,1,['2023-11-30 20:26:28'],['NR']
VC34245693Y,24136,0,24136,OK,0,['2023-12-01 06:24:23'],['NCCR']
VC34245693T,24020,0,24020,OK,0,['2023-12-01 18:34:37'],['NR']
VC341315EAZ,30285,72,30245,OK,40,['2023-12-01 03:10:09'],['NCCR']
VC342456B40,26637,2,26637,OK,0,['2023-12-02 03:52:40'],['NR']
VC342456EFQ,28462,6,28436,OK,26,['2023-12-02 00:46:14'],['NRR']
VC341315B35,30642,0,30642,OK,0,['2023-12-02 14:18:01'],['NR']
VC34245695V,30451,0,30448,OK,3,['2023-12-02 13:52:06'],['NR']
VC341315B36,26636,0,26626,OK,10,['2023-12-03 00:51:01'],['NR']
VC341315B37,33351,0,33351,OK,0,['2023-12-03 01:38:39'],['NRR']
VC342456EF4,30370,0,30360,OK,10,['2023-12-03 10:09:40'],['NR']
VC341315EFX,30530,44,30511,OK,19,['2023-12-03 13:37:16'],['NRR']
VC342456B29,26567,0,26540,OK,27,['2023-12-03 21:47:12'],['NRR']
VC341315EGK,23816,0,23814,OK,2,['2023-12-04 02:11:36'],['NR']
VC34131693Z,28553,0,28538,OK,15,['2023-12-04 08:58:24'],['NCR']
VC341316946,28579,0,28579,OK,0,['2023-12-04 22:07:32'],['NR']
VC34131694C,28610,0,28610,OK,0,['2023-12-05 07:58:20'],['NR']
VC341316931,28571,0,28563,OK,8,['2023-12-05 19:20:59'],['NCCRR']
VC341315B38,26682,0,26661,OK,21,['2023-12-05 11:56:09'],['NR']
VC341315EBM,30533,0,30506,OK,27,['2023-12-07 00:50:30'],['NR']
VC34131693T,28563,18,28382,OK,181,['2023-12-06 08:41:56'],['NCCCR']
VC341315B46,26694,0,26690,OK,4,['2023-12-07 13:43:43'],['NR']
VC341315EGV,28648,0,28647,OK,1,['2023-12-07 13:09:27'],['NCCR']
VC341315EBB,26680,0,26680,OK,0,['2023-12-07 22:17:05'],['NR']
VC341315B50,26717,0,26716,OK,1,['2023-12-08 06:42:00'],['NCR']
VC341315EFM,30598,13,30584,OK,14,['2023-12-08 01:45:49'],['NCCR']
VC341315B51,26746,0,26732,OK,14,['2023-12-08 17:01:31'],['NR']
VC34245694Q,28496,0,28450,OK,46,['2023-12-09 03:00:13'],['NCR']
VC34131694I,21936,7,21852,OK,84,['2023-12-09 00:36:42'],['NCRR']
VC341316B01,26662,0,26658,OK,4,['2023-12-10 18:31:20'],['NRR']
VC341316B07,26626,0,26619,OK,7,['2023-12-11 03:31:51'],['NR']
VC341316937,30092,73,30072,OK,20,['2023-12-10 19:12:19'],['NCCCCCCRR']
VC341315EG9,30063,1,30054,OK,9,['2023-12-11 12:34:21'],['NR']
VC34131694M,28452,0,28414,OK,38,['2023-12-11 21:20:52'],['NR']
VC34131693I,30372,4,30372,OK,0,['2023-12-11 19:18:35'],['NRR']
VC341315EBX,28645,0,28619,OK,26,['2023-12-12 05:58:51'],['NR']
VC341315EF4,28645,0,28636,OK,9,['2023-12-12 07:20:31'],['NR']
VC34131694S,28556,0,28542,OK,14,['2023-12-12 17:05:45'],['NR']
VC341315EFA,28070,244,27899,OK,171,['2023-12-06 00:15:11'],['NCCCCCCCCR']
VC343908931,30248,40,30243,OK,5,['2023-12-15 18:29:03'],['NRR']
VC343908B01,26488,35,26482,OK,6,['2023-12-16 15:09:46'],['NCCRR']
VC34131695A,28489,66,28464,OK,25,['2023-12-17 01:30:34'],['NCCCCCR']
VC34131694Y,30438,0,30437,OK,1,['2023-12-17 11:43:03'],['NRR']
VC342456EG8,30430,0,30414,OK,16,['2023-12-18 01:06:46'],['NCR']
VC342456EGJ,28495,79,28458,OK,37,['2023-12-17 21:20:18'],['NCCCCR']
VC341316B14,26599,0,26597,OK,2,['2023-12-18 17:14:01'],['NR']
VC342456EFW,30430,14,30427,OK,3,['2023-12-18 18:27:23'],['NCCCCR']
VC34390893N,30261,13,30261,OK,0,['2023-12-19 02:56:09'],['NRR']
VC342456B55,26594,4,26592,OK,2,['2023-12-19 09:31:17'],['NR']
VC34390893C,30481,0,30481,OK,0,['2023-12-19 16:53:13'],['NRR']
VC342456B54,26683,0,26683,OK,0,['2023-12-19 20:59:08'],['NR']
VC343908B03,26649,0,26649,OK,0,['2023-12-20 04:29:45'],['NRR']
VC34543393I,28645,0,28643,OK,2,['2023-12-20 17:15:18'],['NR']
VC343908B05,26653,12,26653,OK,0,['2023-12-20 23:04:09'],['NCCCCRR']
VC343908B06,26642,0,26636,OK,6,['2023-12-21 09:09:41'],['NCCCR']
VC345433931,30351,0,30351,OK,0,['2023-12-21 05:32:40'],['NCR']
VC343908959,30584,0,30584,OK,0,['2023-12-21 19:21:41'],['NCCRR']
VC345433B01,26705,0,26705,OK,0,['2023-12-21 22:35:29'],['NCR']
VC343908B07,26710,0,26709,OK,1,['2023-12-22 07:38:55'],['NCR']
VC34543393C,28698,0,28697,OK,1,['2023-12-22 11:00:44'],['NCR']
VC34390895V,30580,0,30579,OK,1,['2023-12-22 18:05:37'],['NR']
VC343908B04,26373,0,26373,OK,0,['2023-12-20 07:25:06'],['NCR']
VC34543393O,28673,0,28673,OK,0,['2023-12-23 00:06:15'],['NCR']
VC34390894X,30453,0,30447,OK,6,['2023-12-23 05:24:27'],['NCCRR']
VC34390893Y,28690,0,28690,OK,0,['2023-12-23 12:57:33'],['NRR']
VC34390894M,30373,0,30364,OK,9,['2023-12-23 16:38:50'],['NR']
VC34543393U,28577,0,28552,OK,25,['2023-12-24 02:46:04'],['NCCR']
VC343908B09,26566,0,26558,OK,8,['2024-01-02 08:02:05'],['NCCCR']
VC34390894B,30545,0,30535,OK,10,['2024-01-02 22:10:13'],['NR']
VC343908945,28356,0,28352,OK,4,['2024-01-02 21:51:21'],['NR']
VC348239947,28492,1,28492,OK,0,['2024-01-03 10:05:20'],['NR']
VC343908B10,26578,29,26578,OK,0,['2024-01-03 10:47:16'],['NCCCCCCRR']
ZA342416932,29342,84,29310,OK,32,['2024-01-02 20:53:37'],['NCCR']
VC34390895K,30343,0,30343,OK,0,['2024-01-04 00:10:10'],['NCCR']
VC343908B11,26520,74,26496,OK,24,['2024-01-04 19:45:58'],['NCCR']
VC34823995G,28650,1,28628,OK,22,['2024-01-05 18:07:44'],['NR']
VC345433941,30116,9,30096,OK,20,['2024-01-06 11:58:31'],['NCCRR']
VC34823994U,26481,0,26441,OK,40,['2024-01-06 07:58:25'],['NCCCCCCCCCRR']
VC34823994Z,26759,0,26704,OK,55,['2024-01-07 05:10:53'],['NCCR']
VC34823994D,26605,0,26588,OK,17,['2024-01-04 00:13:41'],['NR']
VC348239EAK,30458,57,30442,OK,16,['2024-01-07 20:07:39'],['NCRR']
VC34823995W,28105,0,28090,OK,15,['2024-01-08 02:57:06'],['NCCRR']
VC348239B06,26605,1,26561,OK,44,['2024-01-08 12:00:05'],['NCRR']
VC348239EFK,30543,19,30533,OK,10,['2024-01-08 20:52:36'],['NR']
VC348239955,26890,0,26873,OK,17,['2024-01-09 00:32:25'],['NRR']
VC348239EBV,28438,1,28437,OK,1,['2024-01-09 08:03:09'],['NR']
VC34823995Q,28593,0,28555,OK,38,['2024-01-09 10:52:55'],['NCRR']
VC348239EB2,28377,0,28345,OK,32,['2024-01-09 09:40:17'],['NCCCCCCRR']
VC348239B01,26559,0,26539,OK,20,['2024-01-10 01:56:07'],['NRR']
VC348239B07,26622,1,26606,OK,16,['2024-01-10 05:42:57'],['NCR']
VC348239EF8,28125,84,28064,OK,61,['2024-01-09 23:32:40'],['NCCR']
VC348239B13,26547,0,26547,OK,0,['2024-01-11 16:43:50'],['NR']
VC348239EA9,30128,59,29975,OK,153,['2024-01-10 14:30:56'],['NR']
VC345433B04,26569,0,26474,OK,95,['2024-01-11 09:10:39'],['NRR']
VC348239EAV,28526,4,28506,OK,20,['2024-01-11 20:44:20'],['NR']
VC348239EBE,28512,0,28499,OK,13,['2024-01-11 11:54:18'],['NRR']
VC348239B10,26503,45,26430,OK,73,['2024-01-10 19:00:52'],['NCR']
VC348239EFE,28245,23,28203,OK,42,['2024-01-10 18:10:56'],['NCCR']
VC348239EB8,28453,2,28452,OK,1,['2024-01-11 23:49:50'],['NR']
VC34823993M,26872,0,26872,OK,0,['2024-01-12 07:36:55'],['NR']
VC34823993C,28477,2,28464,OK,13,['2024-01-12 10:37:50'],['NRR']
VC34823993W,26741,0,26741,OK,0,['2024-01-12 16:31:11'],['NR']
VC348239EBK,30056,0,30024,OK,32,['2024-01-12 06:03:42'],['NCCCR']
VC348239931,30500,0,30477,OK,23,['2024-01-13 01:32:00'],['NR']
VC348239EF2,28637,0,28587,OK,50,['2024-01-13 00:08:16'],['NCCR']
VC34668693I,28678,0,28672,OK,6,['2024-01-13 12:15:20'],['NR']
VC348239B05,26691,0,26690,OK,1,['2024-01-13 12:02:43'],['NR']
VC348239B03,26663,0,26663,OK,0,['2024-01-13 21:49:43'],['NCR']
VC34668693O,28474,0,28474,OK,0,['2024-01-13 22:29:01'],['NCR']
VC348239B04,26581,0,26571,OK,10,['2024-01-14 07:32:11'],['NRR']
VC34668693C,28554,0,28554,OK,0,['2024-01-14 09:41:11'],['NR']
VC34543394I,30574,0,30551,OK,23,['2024-01-14 17:38:44'],['NCR']
VC348239EGD,28726,0,28723,OK,3,['2024-01-14 20:23:38'],['NRR']
VC348239EG7,28563,0,28563,OK,0,['2024-01-15 04:33:21'],['NCR']
VC348239B32,26704,4,26704,OK,0,['2024-01-15 13:25:06'],['NR']
VC346686931,37104,0,37104,OK,0,['2024-01-15 11:36:01'],['NRR']
VC34823994I,28664,0,28664,OK,0,['2024-01-16 16:11:35'],['NR']
VC345433B07,26589,0,26573,OK,16,['2024-01-15 21:55:10'],['NCR']
VC34543394C,28527,0,28497,OK,30,['2024-01-16 08:27:49'],['NCRR']
VC348239B09,26698,0,26698,OK,0,['2024-01-16 07:16:14'],['NR']
VC348239EFV,30729,0,30729,OK,0,['2024-01-15 06:06:46'],['NCRR']
VC34823995A,28538,0,28525,OK,13,['2024-01-16 19:06:48'],['NCR']
VC348239EA3,28498,0,28478,OK,20,['2024-01-17 08:25:39'],['NR']
VC346686B01,20030,0,20030,OK,0,['2024-01-17 18:43:33'],['NR']
VC34823994O,28098,3,28050,OK,48,['2024-01-07 09:05:22'],['NCRR']
VC346686952,28596,0,28572,OK,24,['2024-01-22 21:30:24'],['NCR']
VC346686958,28476,3,28476,OK,0,['2024-01-23 12:11:19'],['NCCR']
VC346686941,28331,0,28305,OK,26,['2024-01-24 02:21:19'],['NCCR']
VC346686947,28622,1,28587,OK,35,['2024-01-24 17:39:10'],['NCR']
VC34668693U,28385,0,28324,OK,61,['2024-01-25 05:04:08'],['NCR']
VC34953693H,20961,0,20897,OK,64,['2024-01-25 19:34:00'],['NR']
VC34953693L,21144,1,21047,OK,97,['2024-01-26 03:29:52'],['NCRR']
VC34668695K,28560,0,28539,OK,21,['2024-01-26 12:44:29'],['NR']
VC34668694J,28652,0,28652,OK,0,['2024-01-26 21:34:04'],['NR']
VC34668694D,28485,0,28481,OK,4,['2024-01-27 06:07:59'],['N']
VC34953693D,21098,0,21092,OK,6,['2024-01-27 14:30:59'],['N']
VC349536931,30099,0,30078,OK,21,['2024-01-27 21:00:39'],['NCR']
VC349536B01,33393,0,33391,OK,2,['2024-01-28 07:19:39'],['NR']
VC34953694Q,42353,0,42341,OK,12,['2024-01-28 17:43:02'],['NR']
VC34953694Y,21192,0,21192,OK,0,['2024-01-29 07:29:34'],['NCR']
VC34668694P,28630,0,28630,OK,0,['2024-01-29 15:56:49'],['NR']
VC349536B02,33287,0,33275,OK,12,['2024-01-30 00:37:05'],['N']
VC349536942,30151,0,30147,OK,4,['2024-01-30 11:06:57'],['N']
VC346686EA3,30607,0,30604,OK,3,['2024-01-30 20:27:01'],['NR']
VC34668695W,28442,0,28422,OK,20,['2024-01-31 09:26:59'],['N']
VC346686B14,26702,0,26702,OK,0,['2024-02-01 17:14:59'],['NR']
VC34668695Q,28418,6,28418,OK,0,['2024-02-02 02:16:49'],['NR']
VC34668694V,28532,0,28520,OK,12,['2024-02-02 14:12:48'],['NR']
VC349536B11,33319,10,33288,OK,31,['2024-02-03 00:26:33'],['NCR']
VC34953694E,30216,0,30206,OK,10,['2024-02-03 14:26:04'],['NR']
VC34953693T,20773,0,20769,OK,4,['2024-02-04 01:19:02'],['N']
VC34953693P,21189,0,21175,OK,14,['2024-02-04 10:56:12'],['N']
VC351086931,26734,0,26733,OK,1,['2024-02-04 18:11:54'],['N']
VC351086B01,26485,16,26430,OK,55,['2024-02-05 06:15:34'],['NR']
VC34953693X,20796,0,20784,OK,12,['2024-02-05 20:51:05'],['NCR']
VC35108693B,30525,10,30449,OK,76,['2024-02-06 04:28:44'],['NCR']
VC351086B02,26526,0,26525,OK,1,['2024-02-06 14:24:20'],['NCCR']
VC351086945,23917,21,23911,OK,6,['2024-02-21 04:29:40'],['NR']
VC351086B07,26482,0,26437,OK,45,['2024-02-20 14:04:21'],['NCCR']
VC35108693Y,28538,0,28537,OK,1,['2024-02-21 14:31:24'],['NR']
VC35108693S,28583,0,28581,OK,2,['2024-02-22 02:03:14'],['NR']
VC351086951,28565,0,28556,OK,9,['2024-02-22 17:10:29'],['NCR']
VC35108694U,28563,0,28563,OK,0,['2024-02-23 04:20:36'],['NR']
VC35108694E,23843,0,23833,OK,10,['2024-02-23 15:59:45'],['NR']
VC35108694J,28556,9,28524,OK,32,['2024-02-24 01:19:35'],['NR']
VC35108693M,28552,2,28448,OK,104,['2024-02-24 13:08:36'],['NCR']
VC351086957,28554,1,28555,FAIL,1,['2024-03-04 00:05:26'],['NR']
VC35108695D,28511,0,28509,OK,2,['2024-03-04 10:58:53'],['NR']
VC35108695P,28642,1,28641,OK,1,['2024-03-04 21:59:13'],['NR']
VC35108695V,28573,0,28566,OK,7,['2024-03-05 08:24:36'],['NR']
VC351086EA2,28330,0,28327,OK,3,['2024-03-05 09:06:21'],['NCCR']
VC35108695J,28521,13,28521,OK,0,['2024-03-05 18:23:55'],['NR']
VC351086EA8,28254,40,28116,OK,138,['2024-03-04 13:57:20'],['NR']
VC351086EB1,28324,14,28324,OK,0,['2024-03-06 01:28:24'],['NRR']
VC351086EFB,30481,29,30480,OK,1,['2024-03-06 04:43:28'],['NR']
VC351086B18,26571,0,26549,OK,22,['2024-03-06 16:03:06'],['NR']
VC351086EAE,30333,48,30338,FAIL,5,['2024-03-06 17:53:47'],['NCCRR']
VC351086EAP,32999,0,32997,OK,2,['2024-03-07 17:16:53'],['NCR']
VC351086B19,26472,0,26443,OK,29,['2024-03-08 09:40:45'],['NCCCR']
VC351086EBI,32958,139,32856,OK,102,['2024-03-09 00:39:32'],['NCCRR']
VC351086EB7,30214,0,30201,OK,13,['2024-03-10 01:23:27'],['NCR']
VC351086B20,23643,0,23638,OK,5,['2024-03-10 15:08:05'],['NR']
VC351086B21,26455,0,26446,OK,9,['2024-03-11 01:53:55'],['NR']
VC351086EBT,33122,7,33116,OK,6,['2024-03-11 13:33:49'],['NR']
VC351086EF5,28421,8,28420,OK,1,['2024-03-12 04:16:48'],['NRR']
VC351086B22,23667,0,23613,OK,54,['2024-03-12 19:50:01'],['NR']
VC35108593X,28665,0,28665,OK,0,['2024-03-13 00:03:42'],['NCR']
VC351086B30,23722,4,23722,OK,0,['2024-03-13 08:52:42'],['NRR']
VC351085B01,26677,0,26677,OK,0,['2024-03-13 10:32:47'],['NCRR']
VC35108593D,23844,0,23844,OK,0,['2024-03-13 20:17:28'],['NR']
VC351085937,28505,0,28504,OK,1,['2024-03-14 22:06:29'],['NC']
VC312642S10,26641,4,26632,OK,9,['2024-03-14 05:30:55'],['NCCCCRR']
VC351086EFM,30399,0,30269,OK,130,['2024-03-15 08:28:03'],['N']
VC35108593M,30559,0,30552,OK,7,['2024-03-15 13:51:55'],['NCRR']
VC351086B29,26693,0,26693,OK,0,['2024-03-15 22:33:22'],['N']
VC351085B03,26893,0,26877,OK,16,['2024-03-16 01:59:03'],['NRR']
VC35108694P,25887,0,25887,OK,0,['2024-03-16 07:57:55'],['NC']
VC35108594F,28578,0,28571,OK,7,['2024-03-16 12:24:50'],['NRR']
VC351085944,30546,0,30451,OK,95,['2024-03-16 22:18:24'],['NCCR']
VC351085B05,26676,0,26676,OK,0,['2024-03-17 13:15:13'],['NR']
VC35108594L,28466,0,28466,OK,0,['2024-03-17 22:18:43'],['NRR']
VC35108594R,28557,0,28533,OK,24,['2024-03-18 08:56:54'],['NCCR']
ZA342416938,29397,117,29363,OK,34,['2024-03-18 14:20:35'],['NCCCR']
ZA34241693E,4907,13,4902,OK,5,['2024-03-19 18:01:49'],['NRR']
VC35108595M,30481,0,30477,OK,4,['2024-03-19 19:47:09'],['NCR']
VC351086EAE,30230,0,30185,OK,45,['2024-03-19 05:18:24'],['NR']
VC351085931,28114,0,28113,OK,1,['2024-03-13 20:51:11'],['NRR']
VC351085B10,33341,0,33341,OK,0,['2024-03-20 07:51:40'],['NCR']
VC351086957,28451,1,28443,OK,8,['2024-03-12 13:03:49'],['NR']
VC351085EAB,30296,16,30267,OK,29,['2024-03-22 18:38:42'],['NCRR']
VC35108595D,21399,0,21399,OK,0,['2024-03-23 18:04:31'],['NCR']
VC351085B18,26716,17,26587,OK,129,['2024-03-23 15:59:04'],['NRR']
VC351085B17,33287,2,33287,OK,0,['2024-03-24 02:57:07'],['NR']
VC351085B16,33328,0,33183,OK,145,['2024-03-24 02:42:58'],['NRR']
VC351085EB8,30532,70,30470,OK,62,['2024-03-24 14:02:12'],['NCRR']
VC35108595Y,30362,0,30291,OK,71,['2024-03-24 19:04:46'],['NR']
VC351918931,30498,5,30495,OK,3,['2024-03-25 05:58:03'],['NCR']
VC351085B21,33178,35,33035,OK,143,['2024-03-25 09:10:42'],['NCCRR']
VC351085B23,26590,21,26569,OK,21,['2024-03-26 01:05:17'],['NCCR']
VC351918B01,26556,99,26433,OK,123,['2024-03-26 03:00:33'],['NCCCR']
VC351085B22,33259,0,33259,OK,0,['2024-03-26 20:05:07'],['NR']
VC351085EAZ,15995,4,15983,OK,12,['2024-03-27 07:13:22'],['NR']
VC351085EAN,30356,0,30356,OK,0,['2024-03-27 13:18:52'],['NCRR']
VC35191895Z,28437,0,28435,OK,2,['2024-03-27 18:07:26'],['NCRR']
VC351918B02,26688,0,26682,OK,6,['2024-03-28 02:00:18'],['NR']
VC351918B03,26655,0,26655,OK,0,['2024-03-28 11:19:22'],['NCR']
VC35191893M,30425,0,30411,OK,14,['2024-03-28 12:03:51'],['NRR']
VC351918952,30599,0,30589,OK,10,['2024-03-28 21:00:16'],['NCR']
VC35191893X,30374,0,30371,OK,3,['2024-03-28 23:32:16'],['NCRR']
VC35191894Q,30478,0,30473,OK,5,['2024-03-29 07:57:44'],['NR']
VC351918B05,26660,0,26660,OK,0,['2024-03-29 21:53:30'],['NR']
VC351918B14,26570,0,26567,OK,3,['2024-03-30 08:56:53'],['NR']
VC35191895T,28627,0,28611,OK,16,['2024-03-30 07:14:39'],['NCR']
VC351918B07,26655,0,26654,OK,1,['2024-03-30 18:20:45'],['NR']
VC35191895N,28351,0,28351,OK,0,['2024-03-30 18:55:17'],['NR']
VC351918B09,26622,0,26619,OK,3,['2024-03-31 04:18:08'],['NR']
VC351918EBX,28437,0,28418,OK,19,['2024-03-31 05:13:29'],['NCCR']
VC351918B15,26497,2,26487,OK,10,['2024-03-31 13:37:43'],['NR']
VC35191894F,30566,0,30563,OK,3,['2024-03-31 16:55:15'],['NR']
VC35191893C,27444,0,27443,OK,1,['2024-03-31 23:42:28'],['NR']
VC351918EBM,30141,0,30141,OK,0,['2024-04-01 03:43:35'],['NR']
VC351918B10,26496,0,26487,OK,9,['2024-04-01 08:48:12'],['NR']
VC351918EBG,28654,0,28651,OK,3,['2024-04-01 13:17:59'],['NR']
VC351918EA6,30187,12,30186,OK,1,['2024-04-01 20:21:07'],['NCCR']
VC35191895D,26929,0,26926,OK,3,['2024-03-29 20:30:13'],['NR']
VC351085957,28363,0,28354,OK,9,['2024-04-02 11:10:25'],['NCCRR']
VC35108594X,20892,0,20892,OK,0,['2024-04-03 00:44:13'],['NCR']
VC351085B40,26534,0,26534,OK,0,['2024-04-04 01:02:30'],['NR']
VC351918EAS,30165,0,30155,OK,10,['2024-04-04 12:52:01'],['NCR']
VC351918B19,26410,0,26410,OK,0,['2024-04-05 02:43:30'],['NR']
VC351918EB4,28412,0,28407,OK,5,['2024-04-05 14:32:13'],['NR']
VC351918B22,26541,0,26541,OK,0,['2024-04-06 03:22:08'],['NR']
VC351918B28,26538,8,26533,OK,5,['2024-04-06 15:17:44'],['NRR']
VC351918EBA,28298,0,28298,OK,0,['2024-04-07 03:57:04'],['NR']
VC351918EAH,30181,5,30176,OK,5,['2024-04-07 17:24:30'],['NCR']
VC351918B38,26643,0,26639,OK,4,['2024-04-13 10:38:54'],['NR']
VC351918EFF,30095,0,30081,OK,14,['2024-04-13 23:46:46'],['NCCCR']
VC351918EG1,28560,0,28549,OK,11,['2024-04-14 17:26:02'],['NR']
VC351918EF4,30195,0,30193,OK,2,['2024-04-15 04:26:38'],['NCCCCR']
VC351918B37,26510,0,26510,OK,0,['2024-04-15 19:44:10'],['NR']
VC351918B44,26458,0,26451,OK,7,['2024-04-16 07:11:10'],['NCR']
VC351918EFQ,29933,1,29934,FAIL,1,['2024-04-16 20:27:05'],['NR']
ZA135389L5G,4756,0,4756,OK,0,['2024-02-25 02:35:29'],['NR']
ZA135389L5E,4722,0,4722,OK,0,['2024-02-25 07:32:23'],['NR']
ZA135389L5F,4672,0,4672,OK,0,['2024-02-25 04:45:44'],['NR']
VC351918EFQ,29823,1,29691,FAIL,132,['2024-04-25 18:32:08'],['NR']
VC351918EFQ,29395,3,29325,OK,70,['2024-04-28 06:07:04'],['NCC']
VC41643193P,28613,0,28613,OK,0,['2024-04-29 15:52:33'],['NC']
VC312642B28,26589,75,26554,OK,35,['2023-06-12 05:58:26'],['NCRR']
VC416431931,36858,32,36811,OK,47,['2024-04-29 17:39:52'],['NRR']
VC41643193E,28473,0,28469,OK,4,['2024-04-29 23:42:28'],['NR']
VC41643193K,26858,0,26858,OK,0,['2024-04-30 07:52:54'],['NC']
VC41643194X,28500,0,28492,OK,8,['2024-04-30 09:28:02'],['NR']
VC41643194H,20982,0,20980,OK,2,['2024-04-30 18:55:56'],['NR']
VC41643194P,20914,0,20905,OK,9,['2024-05-01 01:38:41'],['NRR']
VC41643194L,20958,0,20944,OK,14,['2024-05-01 10:11:39'],['NRR']
VC417813931,28561,0,28561,OK,0,['2024-05-02 05:25:45'],['NCCRR']
VC41643194T,20866,0,20866,OK,0,['2024-05-02 17:23:46'],['NRR']
VC416431954,28663,0,28657,OK,6,['2024-05-03 00:49:58'],['NR']
VC41643195A,19368,0,19332,OK,36,['2024-05-03 12:23:10'],['NRR']
VC41643195K,28446,0,28437,OK,9,['2024-05-06 05:00:14'],['NC']
VC417813959,28600,0,28600,OK,0,['2024-05-06 17:34:27'],['NR']
VC417813B01,26691,0,26669,OK,22,['2024-05-07 19:08:22'],['NR']
VC41781394X,30425,0,30406,OK,19,['2024-05-07 05:28:26'],['N']
VC41781393I,30480,0,30477,OK,3,['2024-05-10 18:13:25'],['NCCR']
VC417813B06,33361,7,33343,OK,18,['2024-05-10 17:43:04'],['NCR']
VC417813B07,26676,0,26675,OK,1,['2024-05-11 05:04:45'],['NR']
VC419271931,28550,0,28394,OK,156,['2024-05-11 09:24:39'],['NCCR']
VC41781393T,30377,0,30375,OK,2,['2024-05-11 15:22:18'],['NCR']
PF352603B01,26636,15,26543,OK,93,['2024-05-11 13:52:36'],['NCCR']
VC417813B08,26632,0,26630,OK,2,['2024-05-12 01:54:12'],['NR']
VC417813B09,26717,0,26671,OK,46,['2024-05-11 22:14:12'],['NCCR']
PF352603932,24542,0,24489,OK,53,['2024-05-12 02:26:05'],['NR']
VC417813945,28451,0,28448,OK,3,['2024-05-12 09:31:34'],['NR']
VC41643195Q,19448,0,19425,OK,23,['2024-05-12 10:28:39'],['NR']
VC41781395F,28400,14,28388,OK,12,['2024-05-12 10:51:34'],['NR']
VC419271937,30248,0,30248,OK,0,['2024-05-12 17:57:55'],['NCR']
VC419271B01,26487,0,26487,OK,0,['2024-05-12 23:08:09'],['NR']
VC41781394M,23276,153,23326,FAIL,50,['2024-05-12 19:04:02'],['NCCCCCCR']
VC41643193V,20252,1,20233,OK,19,['2024-04-28 22:50:20'],['NCRR']
VC41643193Z,28136,0,28133,OK,3,['2024-04-29 04:44:27'],['NCCRR']
VC41781394B,30550,0,30532,OK,18,['2024-05-13 17:30:53'],['NCCCCCCCCCCCR']
VC41781394M,22496,773,23203,FAIL,707,['2024-05-14 20:13:07'],['NR']
VC419271953,28454,25,28312,OK,142,['2024-05-18 22:54:22'],['NCRR']
VC419271945,30364,24,30199,OK,165,['2024-05-19 15:10:23'],['NCRR']
VC41927194G,26582,0,26576,OK,6,['2024-05-20 03:33:46'],['NR']
VC41927193I,30335,0,30287,OK,48,['2024-05-20 12:37:06'],['NC']
VC41927194R,30455,0,30455,OK,0,['2024-05-20 13:18:39'],['NR']
VC419271B05,30455,0,30332,OK,123,['2024-05-20 23:09:41'],['NR']
VC419271B04,26574,0,26480,OK,94,['2024-05-21 00:07:36'],['NR']
VC419271B06,26577,0,26574,OK,3,['2024-05-21 13:21:40'],['NRR']
VC41927193T,30286,0,30202,OK,84,['2024-05-21 11:05:35'],['NR']
VC419271B07,26562,0,26492,OK,70,['2024-05-21 21:30:37'],['NC']
VC419271B08,26389,0,26373,OK,16,['2024-05-21 21:52:04'],['NR']
PF352602931,24652,0,24652,OK,0,['2024-05-22 07:14:13'],['N']
PF352602B01,26684,0,26673,OK,11,['2024-05-22 07:53:47'],['NR']
PF352602B02,26586,0,26562,OK,24,['2024-05-22 13:54:01'],['NC']
PF35260293J,24181,0,24120,OK,61,['2024-05-22 22:31:04'],['N']
PF352602B05,26583,0,26553,OK,30,['2024-05-26 13:51:44'],['NCRR']
PF35260293A,24444,1,24438,OK,6,['2024-05-27 04:37:12'],['NCR']
VC419272EA6,28519,0,28423,OK,96,['2024-05-27 02:39:06'],['NCR']
VC41927294W,30550,0,30528,OK,22,['2024-05-27 15:06:33'],['NR']
VC41927295J,30501,6,30491,OK,10,['2024-05-27 14:42:57'],['NR']
VC419272958,30438,0,30419,OK,19,['2024-05-28 02:05:19'],['NRR']
VC419272B02,26695,4,26671,OK,24,['2024-05-28 03:35:21'],['NCR']
VC419272B03,26647,0,26633,OK,14,['2024-05-28 11:18:55'],['NR']
VC419272B04,26400,0,26381,OK,19,['2024-05-28 13:40:26'],['NRR']
VC419272B05,26720,0,26692,OK,28,['2024-05-28 20:02:49'],['NR']
VC41927294A,30599,5,30575,OK,24,['2024-05-29 12:48:55'],['NCR']
VC41927195L,30383,32,30285,OK,98,['2024-05-29 17:15:25'],['NR']
VC419272931,30557,0,30549,OK,8,['2024-05-30 01:22:30'],['NR']
VC41927195W,28604,0,28565,OK,39,['2024-05-30 04:24:47'],['NR']
VC419271B19,26692,0,26678,OK,14,['2024-05-30 13:24:13'],['NR']
VC419272B01,26615,0,26596,OK,19,['2024-05-30 12:17:02'],['NCR']
VC419272B07,26740,0,26723,OK,17,['2024-05-30 23:43:04'],['NR']
VC41927293C,30446,0,30445,OK,1,['2024-05-31 00:25:07'],['NR']
VC419272B08,26695,0,26694,OK,1,['2024-05-31 10:16:55'],['NRR']
VC41927293Y,30659,7,30655,OK,4,['2024-05-31 10:18:08'],['NR']
VC421998931,28519,0,28494,OK,25,['2024-05-31 20:26:20'],['NR']
VC421999931,25892,0,25892,OK,0,['2024-05-31 19:59:43'],['NR']
VC421998B01,26725,0,26702,OK,23,['2024-06-01 11:03:19'],['NR']
VC421999B01,19671,9,19670,OK,1,['2024-06-01 08:21:03'],['NCR']
VC41927295U,30561,0,30558,OK,3,['2024-06-01 17:00:23'],['NCR']
VC421998937,30581,0,30580,OK,1,['2024-06-01 20:57:50'],['NCR']
VC419272B13,26694,0,26657,OK,37,['2024-06-02 05:36:17'],['NRR']
VC421998B02,26659,0,26657,OK,2,['2024-06-02 07:38:57'],['NCR']
VC42199893I,30675,0,30652,OK,23,['2024-06-02 15:02:31'],['NRR']
VC421998945,30393,0,30379,OK,14,['2024-06-03 01:13:48'],['NR']
VC421999942,36985,1,36977,OK,8,['2024-06-02 18:24:30'],['NCR']
VC421998B03,26573,0,26565,OK,8,['2024-06-03 13:01:11'],['NR']
VC42199993V,28561,3,28516,OK,45,['2024-06-03 11:28:36'],['NCR']
VC42199993A,29575,0,29528,OK,47,['2024-06-03 22:20:33'],['NR']
VC417812B01,26633,0,26632,OK,1,['2024-06-03 23:36:00'],['NR']
VC421999B02,33230,1,33183,OK,47,['2024-06-04 08:21:18'],['NR']
VC42199893T,30603,0,30603,OK,0,['2024-06-04 07:46:37'],['NR']
VC417812934,33007,0,32972,OK,35,['2024-06-04 18:26:34'],['NR']
VC421998B05,33190,19,33171,OK,19,['2024-06-04 19:23:50'],['NCCCCRR']
VC42199993M,20943,11,20942,OK,1,['2024-06-05 10:10:04'],['NRR']
VC42199894G,23674,0,23671,OK,3,['2024-06-05 07:11:18'],['NCR']
VC421999B03,26596,21,26583,OK,13,['2024-06-05 18:06:32'],['NR']
VC41643195E,27875,8,27871,OK,4,['2024-05-01 17:46:14'],['NRR']
VC41643194D,20752,10,20734,OK,18,['2024-05-01 07:38:31'],['NCCR']
VC41643194A,14836,5,14834,OK,2,['2024-04-29 09:56:15'],['NR']
VC416431946,20836,0,20835,OK,1,['2024-04-30 15:29:27'],['NCC']
VC422502931,30500,0,30499,OK,1,['2024-06-06 00:35:21'],['NCR']
VC422501B01,26510,0,26500,OK,10,['2024-06-06 04:29:34'],['N']
VC422501931,30536,0,30532,OK,4,['2024-06-06 10:55:20'],['NR']
VC42250293Y,28572,0,28569,OK,3,['2024-06-06 13:39:08'],['NR']
VC422502B02,26590,0,26586,OK,4,['2024-06-06 23:52:10'],['N']
VC421998B04,26644,4,26642,OK,2,['2024-06-06 21:43:31'],['NR']
VC422502B01,26553,0,26553,OK,0,['2024-06-07 07:41:36'],['N']
VC42250293C,30482,0,30474,OK,8,['2024-06-07 07:20:08'],['NR']
VC41927294L,30632,0,30613,OK,19,['2024-06-07 16:10:44'],['NR']
VC419272B06,26678,0,26678,OK,0,['2024-06-07 17:31:53'],['NCR']
VC41927293N,30565,0,30556,OK,9,['2024-06-08 01:03:00'],['N']
VC419272B18,26738,0,26738,OK,0,['2024-06-08 02:28:30'],['NR']
VC422502B03,26563,0,26512,OK,51,['2024-06-08 11:28:11'],['N']
VC42250293N,30295,1,30291,OK,4,['2024-06-08 10:51:12'],['NR']
VC41781293F,41431,0,41411,OK,20,['2024-06-08 19:13:35'],['NCR']
VC421998B13,26567,0,26554,OK,13,['2024-06-09 08:53:31'],['N']
VC421998959,30401,0,30399,OK,2,['2024-06-09 09:04:20'],['NRR']
VC417812931,14886,0,14886,OK,0,['2024-06-09 19:54:37'],['NCR']
VC421998B14,26584,0,26584,OK,0,['2024-06-09 17:56:52'],['N']
VC42199894X,30288,0,30287,OK,1,['2024-06-08 21:20:15'],['NR']
VC42199894R,28616,0,28616,OK,0,['2024-06-10 02:22:53'],['NR']
VC41927195F,28557,0,28554,OK,3,['2024-06-10 11:06:23'],['N']
VC419271959,28631,0,28630,OK,1,['2024-06-10 22:28:44'],['N']
VC422502945,30143,0,30143,OK,0,['2024-06-12 17:51:24'],['NCR']
VC422502B13,26500,0,26493,OK,7,['2024-06-13 09:15:11'],['NCRR']
VC42250294G,30034,0,30029,OK,5,['2024-06-13 19:13:03'],['NCRR']
VC422502B14,26439,3,26431,OK,8,['2024-06-14 09:20:18'],['NCRR']
VC422502953,28276,2,28270,OK,6,['2024-06-14 22:27:37'],['NCCR']
VC422502959,30270,0,30269,OK,1,['2024-06-15 11:16:06'],['NCCR']
VC422502B15,26591,0,26591,OK,0,['2024-06-16 01:16:08'],['NCR']
VC422502B17,26637,0,26635,OK,2,['2024-06-16 11:31:33'],['NR']
VC42250295K,30529,1,30524,OK,5,['2024-06-16 21:28:44'],['NCCCR']
PF352603B04,26625,0,26617,OK,8,['2024-06-17 23:39:12'],['NCRR']
PF35260393V,24617,0,24611,OK,6,['2024-06-18 10:03:49'],['NR']
VC42250194L,28512,0,28504,OK,8,['2024-06-21 05:49:34'],['NR']
VC422502B22,26586,0,26586,OK,0,['2024-06-21 21:15:13'],['NR']
VC42250295V,30514,0,30514,OK,0,['2024-06-22 07:26:42'],['NCR']
VC422502EA7,28432,18,28424,OK,8,['2024-06-22 19:09:59'],['NCCR']
VC422501B07,33130,20,33120,OK,10,['2024-06-27 00:54:00'],['NR']
VC42250193C,23755,0,23739,OK,16,['2024-06-27 14:17:00'],['NCCR']
VC422501B06,33237,14,33130,OK,107,['2024-06-28 19:19:19'],['NRR']
VC422501B05,33310,0,33281,OK,29,['2024-06-29 00:30:48'],['NCR']
VC42250194A,30434,0,30433,OK,1,['2024-06-29 11:15:44'],['NR']
VC422501B08,26599,0,26585,OK,14,['2024-06-29 12:37:34'],['NCR']
VC42250193N,23805,0,23785,OK,20,['2024-06-28 11:33:12'],['NCR']
VC424229931,30526,0,30505,OK,21,['2024-06-29 23:01:21'],['NCR']
VC42422994E,28709,0,28704,OK,5,['2024-06-30 09:38:10'],['NR']
VC424229943,30535,18,30480,OK,55,['2024-06-30 13:31:37'],['NCRR']
VC424229B02,26699,0,26695,OK,4,['2024-06-30 17:52:45'],['NCRR']
VC42250193Y,23795,0,23773,OK,22,['2024-06-28 00:35:28'],['NR']
VC422502B33,26462,6,26443,OK,19,['2024-07-01 02:20:35'],['NRR']
VC42250294R,30028,0,30028,OK,0,['2024-07-01 10:12:54'],['NCR']
VC424229B01,26540,0,26505,OK,35,['2024-06-29 23:38:04'],['NCCRR']
VC428489B01,26618,11,26616,OK,2,['2024-07-05 19:51:25'],['NCCCR']
VC42848993B,25941,0,25937,OK,4,['2024-07-06 08:39:58'],['NR']
VC428489B02,26642,0,26641,OK,1,['2024-07-06 18:39:25'],['NR']
VC428489931,26808,4,26808,OK,0,['2024-07-07 03:46:15'],['NR']
VC428489944,30064,0,30064,OK,0,['2024-07-07 12:45:33'],['N']
VC42848994G,23649,0,23649,OK,0,['2024-07-07 21:07:22'],['N']
VC428489B05,33292,0,33276,OK,16,['2024-07-08 03:41:53'],['NCCCR']
VC428489B03,33370,0,33368,OK,2,['2024-07-08 21:22:06'],['NR']
VC42848994P,31384,0,31381,OK,3,['2024-07-09 14:04:50'],['NR']
VC42422993R,30085,0,30085,OK,0,['2024-07-10 01:45:14'],['NR']
VC424229B04,26528,0,26528,OK,0,['2024-07-10 11:54:41'],['NCR']
VC428489B06,26710,0,26710,OK,0,['2024-07-10 23:49:13'],['NR']
VC428489B04,26677,0,26677,OK,0,['2024-07-11 07:53:19'],['NR']
VC42849093D,41337,0,41336,OK,1,['2024-07-11 18:42:47'],['NR']
VC428489B09,26563,0,26562,OK,1,['2024-07-12 09:44:17'],['NR']
VC42849094L,30547,0,30547,OK,0,['2024-07-12 19:29:17'],['NR']
VC42848993L,21871,0,21870,OK,1,['2024-07-13 05:46:48'],['NRR']
VC428490B01,26572,0,26570,OK,2,['2024-07-13 13:11:11'],['NR']
VC428490B02,26651,0,26651,OK,0,['2024-07-13 11:20:56'],['NCCR']
VC428489952,26927,0,26897,OK,30,['2024-07-13 22:12:25'],['NCR']
VC42849094A,30433,0,30428,OK,5,['2024-07-13 23:55:06'],['NR']
VC42848993U,24458,0,24445,OK,13,['2024-07-14 09:50:03'],['NR']
VC428490931,34838,0,34829,OK,9,['2024-07-14 10:10:28'],['NR']
VC428489B16,26572,0,26552,OK,20,['2024-07-14 21:48:50'],['NR']
VC428490B04,33300,0,33277,OK,23,['2024-07-14 19:32:28'],['NCR']
VC42849093L,30422,0,30417,OK,5,['2024-07-15 07:55:10'],['N']
VC42849093W,35118,0,35116,OK,2,['2024-07-15 09:35:12'],['NR']
VC428490B05,33331,0,33326,OK,5,['2024-07-15 17:23:29'],['NR']
PF35260394Q,24523,0,24523,OK,0,['2024-07-15 22:28:07'],['NR']
PF352603B09,26677,0,26677,OK,0,['2024-07-16 14:22:57'],['NRR']
PF352602B11,14294,0,14294,OK,0,['2024-07-16 23:39:11'],['NR']
PF35260295E,37949,2,37921,OK,28,['2024-07-16 17:51:30'],['NCR']
PF35260294U,24611,0,24610,OK,1,['2024-07-17 04:52:24'],['NCR']
PF35260293S,36720,2,36714,OK,6,['2024-07-17 08:38:17'],['NR']
PF352602954,24419,0,24401,OK,18,['2024-07-17 21:04:10'],['NCR']
PF35260294K,24733,0,24726,OK,7,['2024-07-18 07:21:58'],['NRR']
PF352602B13,26624,3,26622,OK,2,['2024-07-18 09:56:51'],['NCCRR']
PF352602B15,26762,0,26750,OK,12,['2024-07-18 16:12:12'],['NR']
VC41781394M,23101,1,23092,OK,9,['2024-06-10 01:48:10'],['NR']
PF352602B12,13276,0,13271,OK,5,['2024-07-18 23:52:28'],['NR']
PF352602942,24509,0,24509,OK,0,['2024-07-19 07:19:52'],['NCR']
PF352602B14,26600,0,26583,OK,17,['2024-07-19 02:04:21'],['NR']
PF352602B10,26319,2,26311,OK,8,['2024-07-16 07:19:19'],['NR']
PF352602B17,26732,0,26731,OK,1,['2024-07-19 17:53:54'],['NR']
PF352602B18,26530,1,26531,FAIL,1,['2024-07-20 02:49:16'],['NR']
PF352602B19,26694,0,26640,OK,54,['2024-07-20 02:50:13'],['NCR']
PF35260294B,24625,0,24619,OK,6,['2024-07-20 11:44:52'],['NCR']
PF35260295O,24190,0,24187,OK,3,['2024-07-20 20:43:56'],['NR']
VC428490953,30175,2,30172,OK,3,['2024-07-20 23:45:13'],['NCR']
VC221873937,28409,1,28397,OK,12,['2024-07-21 16:22:53'],['NR']
VC223219937,28500,0,28499,OK,1,['2024-07-21 18:13:19'],['NCCCCR']
VC428490B06,26567,0,26567,OK,0,['2024-07-22 07:52:46'],['NR']
PF352602B18,26358,1,26357,OK,1,['2024-07-22 17:22:42'],['NCR']
VC22187394M,28443,7,28390,OK,53,['2024-07-22 17:34:15'],['NR']
VC223219931,28528,0,28528,OK,0,['2024-07-23 03:38:57'],['NR']
PF352603B10,26715,0,26714,OK,1,['2024-07-23 07:31:30'],['NR']
PF35260295X,24258,0,24258,OK,0,['2024-07-19 18:02:18'],['NR']
VC42848995C,26042,0,26042,OK,0,['2024-07-23 13:15:18'],['NR']
PF352602B22,26209,0,26208,OK,1,['2024-07-20 13:16:36'],['NR']
PF35260394G,24478,0,24478,OK,0,['2024-07-23 19:19:17'],['NR']
VC428489B19,26668,0,26668,OK,0,['2024-07-23 22:05:26'],['NR']
VC42849094W,7854,0,28560,Incomplete EBS,20706,['2024-07-24 06:23:46'],['N']
VC22321993D,28481,0,28478,OK,3,['2024-07-24 11:56:28'],['NR']
VC42849094W,28560,0,28560,OK,0,['2024-07-24 06:23:46'],['NCR']
VC22203093I,28568,0,28553,OK,15,['2024-07-24 15:55:17'],['NCR']
VC22321994P,28521,0,28504,OK,17,['2024-07-24 20:31:52'],['NR']
VC22321993I,28626,0,28626,OK,0,['2024-07-25 01:59:37'],['NR']
PF352602EAG,24221,0,24216,OK,5,['2024-07-25 05:36:02'],['NR']
PF352602B35,26532,0,26531,OK,1,['2024-07-25 11:38:05'],['NC']
VC22321994J,28533,0,28505,OK,28,['2024-07-25 13:51:26'],['NR']
VC22187394W,28421,0,28421,OK,0,['2024-07-25 23:47:58'],['NR']
VC22321994D,28505,0,28500,OK,5,['2024-07-26 00:06:09'],['NR']
VC221873952,28578,0,28558,OK,20,['2024-07-26 09:06:18'],['NRR']
VC22203093O,28460,0,28451,OK,9,['2024-07-26 09:55:18'],['NR']
VC22321994V,28462,0,28452,OK,10,['2024-07-26 19:58:07'],['NCR']
VC221873958,28565,0,28559,OK,6,['2024-07-26 20:25:13'],['NR']
VC22203093T,28619,0,28619,OK,0,['2024-07-27 05:18:23'],['NCCR']
VC22187394R,28306,0,28302,OK,4,['2024-07-27 06:21:06'],['NCR']
VC428490B11,26213,0,26210,OK,3,['2024-07-21 05:03:57'],['NRR']
PF352602EA7,24128,0,24128,OK,0,['2024-07-16 05:28:46'],['NR']
VC221873931,28590,0,28590,OK,0,['2024-08-07 04:31:25'],['NCR']
PF352603946,26588,0,26584,OK,4,['2024-08-09 18:28:08'],['NCR']
PF352603B17,24668,1,24666,OK,2,['2024-08-10 07:05:06'],['NR']
VC423888EAP,30628,0,30628,OK,0,['2024-08-10 15:18:08'],['NR']
VC423888EAF,26820,0,26817,OK,3,['2024-08-11 01:02:35'],['NR']
VC423888B02,26750,0,26749,OK,1,['2024-08-11 11:17:59'],['NR']
VC423888EBL,29459,1,29437,OK,22,['2024-08-11 19:29:18'],['NR']
VC423888B03,26711,0,26696,OK,15,['2024-08-12 06:12:01'],['NCR']
VC423888EB1,27628,0,27628,OK,0,['2024-08-12 16:27:41'],['NR']
VC423888B06,26674,0,26674,OK,0,['2024-08-13 00:36:29'],['NR']
VC423888B05,26638,0,26638,OK,0,['2024-08-13 08:43:39'],['NR']
VC42388893L,27060,5,27054,OK,6,['2024-08-13 17:21:04'],['NR']
VC42388893B,27146,0,27144,OK,2,['2024-08-14 03:39:49'],['NCR']
VC423888B01,26619,0,26614,OK,5,['2024-08-14 16:24:30'],['NR']
VC42388893V,7440,0,27337,Incomplete EBS,19897,['2024-08-15 03:33:50'],['NC']
VC42388893V,27342,0,27337,OK,5,['2024-08-15 03:33:50'],['NCR']
VC423888B04,26685,0,26682,OK,3,['2024-08-20 10:26:55'],['NR']
VC423888B12,26595,14,26592,OK,3,['2024-08-20 20:10:47'],['NRR']
VC423888EBB,28403,0,28396,OK,7,['2024-08-21 07:13:08'],['NCRR']
VC423888B07,26688,0,26673,OK,15,['2024-08-21 19:53:41'],['NR']
PF352602EBR,24179,0,24174,OK,5,['2024-08-22 17:59:59'],['NCRR']
PF352602EAZ,23455,0,23440,OK,15,['2024-08-23 05:17:44'],['NCCRR']
PF352602B46,26341,0,26336,OK,5,['2024-08-24 15:57:18'],['NCR']
VC423888EBV,30150,0,30150,OK,0,['2024-08-25 06:05:16'],['NCR']
VC423888B17,26509,0,26504,OK,5,['2024-08-25 19:06:13'],['NRR']
PF352602B45,26550,1,26539,OK,11,['2024-08-22 06:04:17'],['NCCR']
PF352602EB9,23999,0,23993,OK,6,['2024-08-26 06:11:07'],['NCR']
PF352602B44,26319,0,26315,OK,4,['2024-08-24 01:12:03'],['NCR']
VC423888EF7,28461,0,28430,OK,31,['2024-08-29 04:34:00'],['NCR']
VC423888EAA,26838,0,26835,OK,3,['2024-08-29 19:59:32'],['NCR']
VC437058B01,26599,3,26590,OK,9,['2024-09-04 00:35:57'],['NCCR']
VC437058945,30345,30,30336,OK,9,['2024-09-03 14:57:07'],['NCRR']
VC43705893T,30551,0,30543,OK,8,['2024-09-04 13:40:32'],['NR']
VC43705893I,30315,2,30315,OK,0,['2024-09-04 11:06:16'],['NRR']
VC437058B03,26620,0,26615,OK,5,['2024-09-04 23:01:13'],['NR']
VC437058B02,26690,0,26690,OK,0,['2024-09-04 22:51:43'],['NR']
VC43705894G,28558,0,28555,OK,3,['2024-09-05 07:43:48'],['NR']
VC437058954,28489,1,28483,OK,6,['2024-09-05 09:30:24'],['NRR']
VC43705894S,30321,0,30321,OK,0,['2024-09-05 18:17:45'],['NR']
VC437058B04,26581,0,26580,OK,1,['2024-09-06 04:18:32'],['NR']
VC437058B05,26615,0,26579,OK,36,['2024-09-07 02:02:08'],['NCCCRR']
VC437058937,30499,2,30067,OK,432,['2024-09-06 03:04:56'],['NCRR']
VC437058931,28365,12,28350,OK,15,['2024-09-12 12:40:05'],['NCRR']
VC43705894M,27908,0,28330,FAIL,422,['2024-09-13 19:40:39'],['NR']
PF352602EF1,24664,0,24661,OK,3,['2024-09-19 07:19:56'],['NR']
VC43705894M,28153,1,28135,OK,18,['2024-09-18 19:29:54'],['NR']
PF352602B57,26617,0,26617,OK,0,['2024-09-19 16:39:01'],['NCR']
PF352602B58,26728,0,26728,OK,0,['2024-09-20 08:36:30'],['NR']
PF352602EFL,24816,0,24809,OK,7,['2024-09-20 16:56:20'],['NRR']
PF408005B01,26749,0,26749,OK,0,['2024-09-21 21:14:27'],['NCRR']
PF408005931,24655,0,24655,OK,0,['2024-09-22 05:34:04'],['NR']
PF408005B02,26564,0,26564,OK,0,['2024-09-22 13:16:13'],['NCR']
PF40800593B,24407,0,24400,OK,7,['2024-09-22 22:47:41'],['NR']
PF352602EFB,24682,1,24674,OK,8,['2024-09-21 01:42:53'],['NR']
PF352602B59,26675,1,26671,OK,4,['2024-09-21 11:52:02'],['NRR']
PF408005B06,26618,0,26599,OK,19,['2024-09-27 19:08:39'],['NCR']
PF40800593U,24685,0,24681,OK,4,['2024-09-28 07:55:49'],['NCR']
PF408005945,24651,0,24649,OK,2,['2024-09-28 20:50:14'],['NCR']
PF408005B07,26605,4,26560,OK,45,['2024-09-29 06:32:12'],['NCR']
PF408005B08,26686,12,26690,FAIL,4,['2024-09-29 17:47:39'],['NR']
PF40800594Z,24634,0,24602,OK,32,['2024-09-30 05:48:22'],['NCCR']
PF408005B09,26686,0,26671,OK,15,['2024-09-30 19:28:35'],['NR']
PF408005B11,26620,3,26619,OK,1,['2024-10-01 06:09:00'],['NCR']
PF408005B08,26580,13,26566,OK,14,['2024-10-01 17:16:06'],['NCR']
PF40800594F,24734,16,24734,OK,0,['2024-10-02 06:48:54'],['NRR']
PF40800593K,26695,0,26693,OK,2,['2024-10-04 17:50:40'],['NR']
PF40800595V,27624,0,27624,OK,0,['2024-10-05 03:27:29'],['NR']
PF408005EA6,24674,0,24674,OK,0,['2024-10-05 13:09:45'],['NR']
PF408005EAG,26723,0,26722,OK,1,['2024-10-06 18:40:14'],['NCR']
PF408005B13,26700,0,26695,OK,5,['2024-10-07 04:07:37'],['NR']
PF40800594P,24698,0,24660,OK,38,['2024-10-05 21:33:01'],['NR']
PF408005B15,24652,0,24652,OK,0,['2024-10-07 12:05:13'],['NR']
PF408005B16,24677,23,24685,FAIL,8,['2024-10-06 11:52:19'],['NCCCCCCRR']
PF40800595A,26640,19,26628,OK,12,['2024-10-07 19:53:55'],['NCR']
PF408005EAQ,24501,58,24488,OK,13,['2024-10-08 17:36:56'],['NCCCRR']
PF408005B16,24401,0,24385,OK,16,['2024-10-09 10:42:41'],['NCRR']
PF408005B14,23736,0,23728,OK,8,['2024-10-10 03:57:52'],['NCCRR']
PF415948B01,26672,6,26668,OK,4,['2024-10-11 04:56:46'],['NCR']
PF408004B02,26622,0,26622,OK,0,['2024-10-11 10:33:11'],['NRR']
PF415948931,24573,0,24542,OK,31,['2024-10-11 14:30:19'],['NCRR']
PF415948B02,26686,0,26686,OK,0,['2024-10-11 21:01:21'],['NR']
PF408004EA3,23333,0,23331,OK,2,['2024-10-12 06:23:01'],['NCR']
PF41594893B,24350,1,24343,OK,7,['2024-10-12 01:34:05'],['NCCRR']
PF41594893K,24097,0,24081,OK,16,['2024-10-12 14:54:15'],['NR']
PF415948B04,26548,0,26547,OK,1,['2024-10-12 15:59:21'],['NCRR']
PF408005EBB,24743,0,24743,OK,0,['2024-10-13 00:35:22'],['NR']
PF408005B10,26572,1,26571,OK,1,['2024-10-13 04:16:04'],['NRR']
PF408005B32,26639,0,26635,OK,4,['2024-10-13 08:31:32'],['NR']
PF408005B18,24658,0,24739,FAIL,81,['2024-10-11 00:59:25'],['NCCR']
PF408005B18,24740,0,24739,OK,1,['2024-10-11 00:59:25'],['NCCRR']
PF408005EB1,24539,0,24525,OK,14,['2024-10-13 17:08:00'],['NCCR']
PF408004931,26658,55,26685,FAIL,27,['2024-10-14 04:24:25'],['NCR']
PF408005B42,26281,6,26221,OK,60,['2024-10-13 20:49:04'],['NCRR']
PF408004B01,24302,3,24293,OK,9,['2024-10-14 19:42:29'],['NCCCCCCRR']
ZA413024L44,4671,0,4687,FAIL,16,['2024-10-17 03:04:46'],['N']
ZA413257L4A,4708,0,4708,OK,0,['2024-10-16 06:21:15'],['NR']
ZA413257L42,4727,0,4727,OK,0,['2024-10-17 08:36:27'],['NR']
ZA413257L43,4735,0,4735,OK,0,['2024-10-16 15:12:30'],['NR']
ZA413257L49,4637,0,4637,OK,0,['2024-10-17 05:55:21'],['NCR']
ZA413024L46,4803,0,4803,OK,0,['2024-10-17 00:04:44'],['NR']
ZA413024L47,4801,0,4799,OK,2,['2024-10-16 21:06:00'],['NCR']
ZA413361L42,4439,0,4439,OK,0,['2024-10-16 01:44:55'],['NCRR']
PF40800494M,24149,0,24149,OK,0,['2024-10-17 02:38:03'],['NCR']
ZA413024L42,4717,0,4714,OK,3,['2024-10-16 18:22:41'],['NR']
ZA413257L45,4743,1,4743,OK,0,['2024-10-16 11:27:27'],['NR']
ZA413257L47,4683,0,4683,OK,0,['2024-10-17 11:08:11'],['NR']
PF40800494D,22933,0,22932,OK,1,['2024-10-17 13:04:49'],['NR']
PF408004931,26568,0,26568,OK,0,['2024-10-17 21:05:48'],['NR']
PF408004B08,26608,0,26603,OK,5,['2024-10-18 06:30:40'],['NCR']
PF408004B05,26518,67,26538,FAIL,20,['2024-10-17 14:47:52'],['NCCCRR']
PF408004B06,26615,0,26611,OK,4,['2024-10-18 10:00:10'],['NRR']
PF408004B09,26543,0,26513,OK,30,['2024-10-18 16:53:09'],['NR']
PF40800494V,24642,0,24641,OK,1,['2024-10-18 21:06:25'],['NRR']
VC443837931,29998,0,29997,OK,1,['2024-10-19 04:08:47'],['NR']
VC443837B01,26551,0,26551,OK,0,['2024-10-19 08:09:32'],['NRR']
PF408004B10,25549,0,26596,FAIL,1047,['2024-10-19 14:49:01'],['N']
PF408004B10,26598,0,26596,OK,2,['2024-10-19 14:49:01'],['NR']
PF408004943,24605,0,24603,OK,2,['2024-10-19 20:04:09'],['NRR']
PF40800493A,24107,0,24683,FAIL,576,['2024-10-20 00:33:26'],['N']
PF40800493A,24683,0,24683,OK,0,['2024-10-20 00:33:26'],['NR']
PF40800493K,22398,0,22398,OK,0,['2024-10-20 05:58:22'],['NRR']
PF40800595L,26613,0,26613,OK,0,['2024-10-20 15:56:21'],['NCR']
PF40800493T,23788,0,23788,OK,0,['2024-10-21 02:02:29'],['NR']
PF408005B17,24697,0,24686,OK,11,['2024-10-21 00:51:55'],['NCCCCCR']
PF408004B17,24437,0,26531,Incomplete EBS,2094,['2024-10-21 10:19:23'],['NCCC']
PF408004B17,26537,0,26531,OK,6,['2024-10-21 10:19:23'],['NCCCRR']
PF408004B11,26679,0,26675,OK,4,['2024-10-21 16:01:36'],['NR']
PF408004B05,26357,0,26345,OK,12,['2024-10-22 05:48:45'],['NR']
VC44383794L,17059,0,17059,OK,0,['2024-10-22 10:39:43'],['NCCCRR']
VC443837B04,19944,0,19915,OK,29,['2024-10-22 17:26:53'],['NCR']
VC443837B05,19942,0,19938,OK,4,['2024-10-22 20:23:04'],['NR']
VC44383793N,30578,0,30578,OK,0,['2024-10-23 14:14:07'],['NR']
VC443837B08,26633,0,26633,OK,0,['2024-10-23 23:34:40'],['NCCR']
VC443837B06,26672,12,26679,FAIL,7,['2024-10-23 05:34:55'],['NCRR']
VC44383793Y,30285,0,30266,OK,19,['2024-10-23 02:18:09'],['NCCR']
VC443837B07,26548,0,26546,OK,2,['2024-10-23 18:31:15'],['NR']
VC44383794A,30144,0,30144,OK,0,['2024-10-24 05:12:06'],['NCR']
VC443837B10,26662,10,26628,OK,34,['2024-10-24 08:10:20'],['NCCCR']
VC44383793C,30486,0,30452,OK,34,['2024-10-24 19:43:02'],['NR']
VC443837B06,26483,0,26476,OK,7,['2024-10-24 17:57:14'],['NCRR']
PF41594894E,24524,18,24511,OK,13,['2024-10-31 09:44:07'],['NCCRR']
PF41594893T,24440,13,24411,OK,29,['2024-10-31 23:57:13'],['NCR']
PF415948B09,26545,16,26545,OK,0,['2024-11-01 10:31:30'],['NRR']
PF415948B10,26450,10,26444,OK,6,['2024-11-01 01:49:32'],['NCCCCCCRR']
PF41594894O,24580,0,24577,OK,3,['2024-11-01 20:29:46'],['NR']
PF415948B12,26525,3,26517,OK,8,['2024-11-02 05:53:23'],['NR']
PF415948B13,26511,0,26492,OK,19,['2024-11-02 16:15:13'],['NR']
PF41594894Y,23795,0,23794,OK,1,['2024-11-03 02:08:23'],['NR']
PF40800495M,42141,19,42119,OK,22,['2024-11-03 00:08:51'],['NRR']
PF415948B11,26497,0,26460,OK,37,['2024-11-02 00:18:41'],['NCCR']
PF40800495E,42000,3,41978,OK,22,['2024-11-03 19:37:55'],['NCCCCRR']
PF40800495U,39943,0,39936,OK,7,['2024-11-05 01:20:27'],['NCCCCCCCCR']
PF415948944,24458,0,24453,OK,5,['2024-11-06 07:13:56'],['NR']
PF408004956,21107,0,21072,OK,35,['2024-11-07 15:14:10'],['NCCRR']
VC441467931,33854,3,33842,OK,12,['2024-11-06 18:56:36'],['NCCCRR']
PF408004B29,19916,5,19895,OK,21,['2024-11-08 03:21:53'],['NCRR']
PF43093795A,24654,0,24648,OK,6,['2024-11-08 21:03:00'],['NCCCR']
PF430937B01,26567,0,26566,OK,1,['2024-11-09 10:51:18'],['NRR']
PF43093794F,24698,0,24678,OK,20,['2024-11-10 00:47:52'],['NCCRR']
PF430937B02,26602,0,26602,OK,0,['2024-11-10 12:22:23'],['NR']
ZA413024L44,4642,0,4642,OK,0,['2024-11-08 15:11:01'],['NR']
PF43093794Z,24626,31,24564,OK,62,['2024-11-10 21:37:51'],['NCCCCCR']
PF41594895H,24655,0,24606,OK,49,['2024-11-12 10:55:02'],['NCR']
PF430937B03,26485,21,26316,OK,169,['2024-11-12 01:57:28'],['NCCCCCCCR']
PF415948B23,26607,0,26584,OK,23,['2024-11-12 20:35:37'],['NCRR']
PF43093793U,24563,19,24551,OK,12,['2024-11-13 08:08:54'],['NRR']
PF430937B04,26613,4,26596,OK,17,['2024-11-13 07:09:34'],['NCCCCCCCCR']
PF43093795T,24674,6,24668,OK,6,['2024-11-13 17:28:19'],['NR']
PF430937945,24655,3,24627,OK,28,['2024-11-13 20:14:41'],['NR']
PF430937B07,26538,34,26529,OK,9,['2024-11-14 02:53:01'],['NCR']
PF430937B08,26624,0,26617,OK,7,['2024-11-14 05:13:08'],['NCR']
PF415948958,20219,4,20197,OK,22,['2024-11-14 14:53:03'],['NR']
PF415948B26,26401,12,26330,OK,71,['2024-11-14 18:02:06'],['NRR']
PF430937B11,26621,0,26611,OK,10,['2024-11-15 00:02:00'],['NR']
PF430937B14,26569,0,26530,OK,39,['2024-11-15 04:42:35'],['NCCCRR']
PF442224B01,26525,0,26494,OK,31,['2024-11-15 09:42:35'],['NR']
PF44222493B,25261,0,25261,OK,0,['2024-11-15 17:17:47'],['NCCR']
PF430937EA4,24625,0,24615,OK,10,['2024-11-15 20:22:39'],['NCR']
PF430937B19,26643,0,26643,OK,0,['2024-11-16 05:14:20'],['NCCR']
PF430937B21,26508,0,26475,OK,33,['2024-11-16 09:14:39'],['NCCR']
PF43093794P,24709,0,24709,OK,0,['2024-11-16 16:08:33'],['NR']
PF430937EAE,24531,0,24522,OK,9,['2024-11-16 21:27:17'],['NR']
PF442224B02,26625,0,26625,OK,0,['2024-11-16 23:55:38'],['NR']
PF430937B27,26511,7,26501,OK,10,['2024-11-17 05:44:38'],['NR']
PF430937B25,26602,0,26602,OK,0,['2024-11-17 08:26:57'],['NR']
PF430937931,23320,0,23320,OK,0,['2024-11-17 16:43:24'],['NR']
PF43093793K,24729,0,24694,OK,35,['2024-11-17 14:46:14'],['NR']
PF430937B29,26610,5,26598,OK,12,['2024-11-17 23:35:16'],['NR']
PF415948EA2,24506,0,24493,OK,13,['2024-11-18 00:08:42'],['NCR']
PF415948B31,26621,0,26619,OK,2,['2024-11-18 09:30:04'],['NCR']
PF415948B30,26652,0,26651,OK,1,['2024-11-18 09:33:26'],['NR']
PF43093793A,24728,0,24721,OK,7,['2024-11-18 18:57:52'],['NR']
PF41594895R,24542,0,24407,OK,135,['2024-11-18 18:34:39'],['NR']
PF43093795K,24498,0,24498,OK,0,['2024-11-19 02:39:18'],['NR']
PF44222494Q,25204,0,25204,OK,0,['2024-11-19 02:42:58'],['NR']
PF430937B36,26680,0,26647,OK,33,['2024-11-19 10:33:44'],['NCR']
PF430937EAO,24612,0,24611,OK,1,['2024-11-20 08:27:15'],['N']
PF442224931,25085,0,25036,OK,49,['2024-11-20 15:20:54'],['N']
PF442224B05,26557,0,26554,OK,3,['2024-11-21 00:15:57'],['N']
PF44222493L,25205,0,25184,OK,21,['2024-11-21 09:28:01'],['NR']
PF442224B06,26731,1,26730,OK,1,['2024-11-21 16:54:53'],['NR']
PF442224B10,26542,0,26538,OK,4,['2024-11-22 00:32:55'],['NR']
PF44222494G,25090,0,25086,OK,4,['2024-11-22 10:30:47'],['NR']
PF442224946,25021,12,25012,OK,9,['2024-11-22 19:58:48'],['NRR']
PF442224B12,26471,0,26459,OK,12,['2024-11-23 05:54:08'],['NRR']
PF442224B09,26660,0,26634,OK,26,['2024-12-01 15:07:51'],['NCR']
VC43831994N,28519,0,28519,OK,0,['2024-12-02 09:28:45'],['NCCRR']
VC43831994H,28484,0,28481,OK,3,['2024-12-02 19:49:32'],['NR']
VC43831994T,28635,0,28624,OK,11,['2024-12-03 04:10:11'],['NRR']
VC44383794W,28532,12,28516,OK,16,['2024-12-10 13:03:10'],['NR']
PF442224951,25002,0,25002,OK,0,['2024-12-11 00:23:19'],['NR']
PF442224B14,26503,0,26502,OK,1,['2024-12-11 09:24:46'],['NR']
PF44222493V,24950,0,24937,OK,13,['2024-12-13 02:30:27'],['NCR']
VC43831993Z,28325,0,28325,OK,0,['2024-12-15 07:06:22'],['NCRR']
VC441467938,17509,9,17494,OK,15,['2024-12-15 19:38:47'],['NRR']
VC438319B04,26568,0,26567,OK,1,['2024-12-14 18:59:38'],['NRR']
VC43831993O,30376,0,30306,OK,70,['2024-12-14 03:57:27'],['NCRR']
VC43831993C,28387,0,28359,OK,28,['2024-12-13 17:33:23'],['NR']
VC438319B07,26491,10,26490,OK,1,['2024-12-19 13:45:40'],['NRR']
VC438319946,30360,41,30394,FAIL,34,['2024-12-20 05:04:09'],['NRR']
VC443837B26,26574,0,26574,OK,0,['2024-12-20 22:13:58'],['NRR']
VC43831994Z,28497,0,28497,OK,0,['2024-12-21 09:30:19'],['NR']
VC44383795E,28446,0,28430,OK,16,['2024-12-21 20:38:42'],['NRR']
VC443837953,30602,0,30596,OK,6,['2024-12-22 18:02:03'],['NRR']
VC438319946,30277,0,30277,OK,0,['2024-12-22 06:33:48'],['NRR']
PF452509B01,26650,5,26601,OK,49,['2024-12-23 04:42:01'],['NCRR']
PF452509931,25152,27,25126,OK,26,['2024-12-23 19:47:27'],['NRR']
VC438319B05,26572,0,26570,OK,2,['2024-12-24 06:12:05'],['NR']
VC438319931,30495,0,30473,OK,22,['2024-12-24 17:05:43'],['NR']
ZA34241693I,9778,76,9760,OK,18,['2024-12-29 22:42:25'],['NCR']
ZA34241693K,9833,73,9809,OK,24,['2024-12-30 10:13:09'],['NR']
VC44146793H,17119,0,17118,OK,1,['2025-01-02 10:36:14'],['NCRR']
PF45250994Q,25029,1,25020,OK,9,['2025-01-02 17:24:58'],['NR']
PF452509946,24795,0,24795,OK,0,['2025-01-03 01:51:41'],['NR']
PF45250994G,25119,0,25099,OK,20,['2025-01-03 10:08:45'],['NR']
PF452509B04,26598,0,26597,OK,1,['2025-01-03 19:00:04'],['NR']
PF452509B03,26605,0,26591,OK,14,['2025-01-04 04:05:25'],['NR']
PF452509B05,26666,0,26666,OK,0,['2025-01-04 13:33:32'],['NRR']
PF45250993B,24962,7,24962,OK,0,['2025-01-04 23:35:24'],['NRR']
PF452509B06,26459,5,26460,FAIL,1,['2025-01-05 11:37:52'],['NCRRR']
PF452509B08,26462,0,26447,OK,15,['2025-01-11 03:23:52'],['NCCCCCCCRR']
PF452509951,25106,0,25104,OK,2,['2025-01-12 01:36:06'],['NR']
ZA34241693F,14760,15,14732,OK,28,['2024-12-29 09:13:44'],['NCRR']
PF44222495B,25026,0,24981,OK,45,['2025-01-12 23:06:38'],['NRR']
PF452509B06,26279,2,26267,OK,12,['2025-01-12 11:47:20'],['NRR']
PF45250993V,25013,0,24984,OK,29,['2025-01-13 11:33:00'],['NRR']
PF452509B15,26593,0,26550,OK,43,['2025-01-13 22:11:00'],['NRR']
VC446695B01,26552,0,26506,OK,46,['2025-01-22 10:54:42'],['NCCR']
PF442224B26,26550,0,26540,OK,10,['2025-01-22 23:51:11'],['NRR']
VC44669593N,30017,0,29951,OK,66,['2025-01-23 17:46:31'],['NCCCCRR']
VC446695931,30609,0,30606,OK,3,['2025-01-25 00:17:23'],['NCR']
VC44669593C,30152,7,30115,OK,37,['2025-01-24 08:47:58'],['NCCCR']
VC44383795K,28561,1,28556,OK,5,['2025-01-25 10:29:33'],['NCR']
VC446695B03,26699,0,26698,OK,1,['2025-01-25 21:35:07'],['NR']
PF452509B16,26457,0,26456,OK,1,['2025-01-26 06:35:22'],['NCRR']
PF45250993L,25000,0,24983,OK,17,['2025-01-26 18:33:40'],['NCCRR']
PF505632B01,26690,0,26687,OK,3,['2025-01-27 08:36:53'],['NR']
VC44669593Y,30475,0,30474,OK,1,['2025-01-27 18:21:09'],['NR']
VC446695B05,26639,0,26639,OK,0,['2025-01-28 04:26:42'],['NR']
VC446695B02,26600,1,26601,FAIL,1,['2025-01-28 12:52:54'],['NR']
VC446695B02,26521,1,26521,OK,0,['2025-01-30 13:16:03'],['NCCCRR']
PF505632932,24614,0,24614,OK,0,['2025-01-31 04:35:04'],['NCCCCCCCCCCR']
PF505632B02,26609,0,26597,OK,12,['2025-01-31 20:21:34'],['NRR']
